"codigo_comarca";"nome_comarca";"ano";"denuncias";"com_informacao";"sem_informacao";"com_sentenca";"aguardando_sentenca";"sentenca_julgada_procedente";"sentenca_julgada_improcedente";"processo_extinto";"processo_suspenso";"taxa_com_informacao";"taxa_sem_informacao";"taxa_com_sentenca";"taxa_aguardando_sentenca";"taxa_sentenca_julgada_procedente";"taxa_sentenca_julgada_improcedente";"taxa_processo_extinto";"taxa_processo_suspenso"
1;"Angra dos Reis";"2020";335;224;111;28;196;10;3;15;0;66,9;33,1;12,5;87,5;35,7;10,7;53,6;0
2;"Araruama";"2020";829;135;694;34;101;19;1;14;0;16,3;83,7;25,2;74,8;55,9;2,9;41,2;0
3;"Armação dos Búzios";"2020";154;77;77;8;69;5;0;3;0;50;50;10,4;89,6;62,5;0;37,5;0
4;"Arraial do Cabo";"2020";116;59;57;5;54;2;0;3;0;50,9;49,1;8,5;91,5;40;0;60;0
5;"Barra do Piraí";"2020";284;130;154;38;92;10;4;24;0;45,8;54,2;29,2;70,8;26,3;10,5;63,2;0
6;"Barra Mansa";"2020";622;516;106;91;425;46;10;35;0;83;17;17,6;82,4;50,5;11;38,5;0
7;"Belford Roxo";"2020";223;191;32;46;145;14;3;29;0;85,7;14,3;24,1;75,9;30,4;6,5;63;0
8;"Bom Jardim";"2020";92;30;62;11;19;2;0;9;0;32,6;67,4;36,7;63,3;18,2;0;81,8;0
9;"Bom Jesus do Itabapoana";"2020";174;46;128;21;25;2;2;17;0;26,4;73,6;45,7;54,3;9,5;9,5;81;0
10;"Cabo Frio";"2020";841;597;244;206;391;141;17;47;1;71;29;34,5;65,5;68,4;8,3;22,8;0,5
11;"Cachoeiras de Macacu";"2020";179;113;66;24;89;6;1;17;0;63,1;36,9;21,2;78,8;25;4,2;70,8;0
12;"Cambuci";"2020";40;19;21;13;6;7;0;6;0;47,5;52,5;68,4;31,6;53,8;0;46,2;0
13;"Campos dos Goytacazes";"2020";1287;481;806;98;383;48;6;44;0;37,4;62,6;20,4;79,6;49;6,1;44,9;0
14;"Cantagalo";"2020";82;29;53;18;11;13;0;5;0;35,4;64,6;62,1;37,9;72,2;0;27,8;0
15;"Rio de Janeiro";"2020";18173;12504;5669;4156;8348;1144;450;2492;70;68,8;31,2;33,2;66,8;27,5;10,8;60;1,7
16;"Carapebus/Quissamã";"2020";78;47;31;11;36;2;0;9;0;60,3;39,7;23,4;76,6;18,2;0;81,8;0
17;"Carmo";"2020";108;37;71;17;20;7;0;10;0;34,3;65,7;45,9;54,1;41,2;0;58,8;0
18;"Casimiro de Abreu";"2020";125;9;116;2;7;0;0;2;0;7,2;92,8;22,2;77,8;0;0;100;0
19;"Conceição de Macabu";"2020";77;42;35;21;21;5;0;16;0;54,5;45,5;50;50;23,8;0;76,2;0
20;"Cordeiro";"2020";146;35;111;19;16;5;0;14;0;24;76;54,3;45,7;26,3;0;73,7;0
21;"Duas Barras";"2020";13;4;9;1;3;1;0;0;0;30,8;69,2;25;75;100;0;0;0
22;"Duque de Caxias";"2020";3313;875;2438;216;659;72;11;133;0;26,4;73,6;24,7;75,3;33,3;5,1;61,6;0
23;"Engenheiro Paulo de Frontin";"2020";86;51;35;34;17;17;2;15;0;59,3;40,7;66,7;33,3;50;5,9;44,1;0
24;"Guapimirim";"2020";144;53;91;33;20;11;5;17;0;36,8;63,2;62,3;37,7;33,3;15,2;51,5;0
25;"Iguaba Grande";"2020";106;28;78;10;18;0;0;10;0;26,4;73,6;35,7;64,3;0;0;100;0
26;"Itaboraí";"2020";510;444;66;172;272;112;11;44;5;87,1;12,9;38,7;61,3;65,1;6,4;25,6;2,9
27;"Itaguaí";"2020";376;281;95;21;260;1;0;19;1;74,7;25,3;7,5;92,5;4,8;0;90,5;4,8
28;"Italva(Cardoso Moreira)";"2020";111;98;13;18;80;6;0;12;0;88,3;11,7;18,4;81,6;33,3;0;66,7;0
29;"Itaocara";"2020";145;50;95;14;36;3;0;11;0;34,5;65,5;28;72;21,4;0;78,6;0
30;"Itaperuna";"2020";277;93;184;10;83;3;0;7;0;33,6;66,4;10,8;89,2;30;0;70;0
31;"Itatiaia";"2020";179;94;85;38;56;22;4;12;0;52,5;47,5;40,4;59,6;57,9;10,5;31,6;0
32;"Japeri";"2020";238;100;138;22;78;3;3;16;0;42;58;22;78;13,6;13,6;72,7;0
33;"Laje do Muriaé";"2020";48;28;20;7;21;4;1;2;0;58,3;41,7;25;75;57,1;14,3;28,6;0
34;"Macaé";"2020";621;262;359;90;172;56;4;30;0;42,2;57,8;34,4;65,6;62,2;4,4;33,3;0
35;"Magé";"2020";450;268;182;88;180;15;4;69;0;59,6;40,4;32,8;67,2;17;4,5;78,4;0
36;"Mangaratiba";"2020";196;126;70;11;115;1;0;10;0;64,3;35,7;8,7;91,3;9,1;0;90,9;0
37;"Maricá";"2020";222;121;101;25;96;6;0;19;0;54,5;45,5;20,7;79,3;24;0;76;0
38;"Mendes";"2020";106;30;76;16;14;6;0;10;0;28,3;71,7;53,3;46,7;37,5;0;62,5;0
40;"Miguel Pereira";"2020";81;55;26;14;41;2;1;11;0;67,9;32,1;25,5;74,5;14,3;7,1;78,6;0
41;"Miracema";"2020";165;125;40;54;71;8;0;46;0;75,8;24,2;43,2;56,8;14,8;0;85,2;0
42;"Natividade";"2020";63;49;14;14;35;1;1;12;0;77,8;22,2;28,6;71,4;7,1;7,1;85,7;0
43;"Nilópolis";"2020";174;154;20;82;72;42;11;25;4;88,5;11,5;53,2;46,8;51,2;13,4;30,5;4,9
44;"Niterói";"2020";1664;1275;389;256;1019;69;20;155;12;76,6;23,4;20,1;79,9;27;7,8;60,5;4,7
45;"Nova Friburgo";"2020";714;536;178;54;482;13;10;31;0;75,1;24,9;10,1;89,9;24,1;18,5;57,4;0
46;"Nova Iguaçu";"2020";2554;1317;1237;490;827;76;248;156;10;51,6;48,4;37,2;62,8;15,5;50,6;31,8;2
47;"Paracambi";"2020";158;69;89;58;11;4;2;51;1;43,7;56,3;84,1;15,9;6,9;3,4;87,9;1,7
48;"Paraíba do Sul";"2020";176;116;60;30;86;17;0;13;0;65,9;34,1;25,9;74,1;56,7;0;43,3;0
49;"Paraty";"2020";148;104;44;9;95;2;0;7;0;70,3;29,7;8,7;91,3;22,2;0;77,8;0
50;"Paty do Alferes";"2020";114;85;29;30;55;6;0;24;0;74,6;25,4;35,3;64,7;20;0;80;0
51;"Petrópolis";"2020";1565;1051;514;135;916;17;25;93;0;67,2;32,8;12,8;87,2;12,6;18,5;68,9;0
52;"Pinheiral";"2020";84;64;20;29;35;12;2;15;0;76,2;23,8;45,3;54,7;41,4;6,9;51,7;0
53;"Piraí";"2020";113;66;47;12;54;2;0;10;0;58,4;41,6;18,2;81,8;16,7;0;83,3;0
54;"Porciúncula";"2020";234;146;88;32;114;10;1;21;0;62,4;37,6;21,9;78,1;31,2;3,1;65,6;0
55;"Porto Real-Quatis";"2020";81;41;40;4;37;3;0;1;0;50,6;49,4;9,8;90,2;75;0;25;0
56;"Queimados";"2020";295;101;194;21;80;12;4;5;0;34,2;65,8;20,8;79,2;57,1;19;23,8;0
57;"Resende";"2020";539;378;161;81;297;11;4;66;0;70,1;29,9;21,4;78,6;13,6;4,9;81,5;0
58;"Rio Bonito";"2020";219;118;101;34;84;15;2;17;0;53,9;46,1;28,8;71,2;44,1;5,9;50;0
59;"Rio Claro";"2020";39;20;19;2;18;1;0;1;0;51,3;48,7;10;90;50;0;50;0
60;"Rio Das Flores";"2020";47;27;20;7;20;1;1;5;0;57,4;42,6;25,9;74,1;14,3;14,3;71,4;0
61;"Rio Das Ostras";"2020";492;103;389;15;88;2;0;13;0;20,9;79,1;14,6;85,4;13,3;0;86,7;0
62;"Santa Maria Madalena";"2020";5;5;0;4;1;0;3;1;0;100;0;80;20;0;75;25;0
63;"Santo Antônio de Pádua";"2020";167;59;108;23;36;11;1;11;0;35,3;64,7;39;61;47,8;4,3;47,8;0
64;"São Fidélis";"2020";197;40;157;16;24;5;1;10;0;20,3;79,7;40;60;31,2;6,2;62,5;0
65;"São Francisco do Itabapoana";"2020";66;17;49;9;8;1;0;8;0;25,8;74,2;52,9;47,1;11,1;0;88,9;0
66;"São Gonçalo";"2020";2108;1658;450;497;1161;118;83;225;71;78,7;21,3;30;70;23,7;16,7;45,3;14,3
67;"São João da Barra";"2020";336;237;99;19;218;12;0;7;0;70,5;29,5;8;92;63,2;0;36,8;0
68;"São João de Meriti";"2020";279;231;48;71;160;25;10;36;0;82,8;17,2;30,7;69,3;35,2;14,1;50,7;0
69;"São José do Vale do Rio Preto";"2020";59;25;34;8;17;0;0;8;0;42,4;57,6;32;68;0;0;100;0
70;"São Pedro da Aldeia";"2020";352;287;65;63;224;15;3;45;0;81,5;18,5;22;78;23,8;4,8;71,4;0
71;"São Sebastião do Alto";"2020";29;9;20;6;3;0;0;6;0;31;69;66,7;33,3;0;0;100;0
72;"Sapucaia";"2020";103;14;89;6;8;0;0;6;0;13,6;86,4;42,9;57,1;0;0;100;0
73;"Saquarema";"2020";80;62;18;15;47;12;0;3;0;77,5;22,5;24,2;75,8;80;0;20;0
74;"Seropédica";"2020";255;93;162;34;59;9;2;23;0;36,5;63,5;36,6;63,4;26,5;5,9;67,6;0
75;"Silva Jardim";"2020";126;40;86;10;30;6;0;4;0;31,7;68,3;25;75;60;0;40;0
76;"Sumidouro";"2020";64;38;26;3;35;0;0;3;0;59,4;40,6;7,9;92,1;0;0;100;0
78;"Teresópolis";"2020";585;485;100;72;413;17;9;46;0;82,9;17,1;14,8;85,2;23,6;12,5;63,9;0
79;"Trajano de Moraes";"2020";19;3;16;1;2;0;0;1;0;15,8;84,2;33,3;66,7;0;0;100;0
80;"Três Rios";"2020";676;467;209;84;383;55;0;29;0;69,1;30,9;18;82;65,5;0;34,5;0
81;"Valença";"2020";294;181;113;80;101;2;0;78;0;61,6;38,4;44,2;55,8;2,5;0;97,5;0
82;"Vassouras";"2020";167;128;39;54;74;14;1;39;0;76,6;23,4;42,2;57,8;25,9;1,9;72,2;0
83;"Volta Redonda";"2020";763;351;412;55;296;16;1;38;0;46;54;15,7;84,3;29,1;1,8;69,1;0
1;"Angra dos Reis";"2019";501;302;199;126;176;78;10;38;0;60,3;39,7;41,7;58,3;61,9;7,9;30,2;0
2;"Araruama";"2019";958;286;672;204;82;100;8;96;0;29,9;70,1;71,3;28,7;49;3,9;47,1;0
3;"Armação dos Búzios";"2019";221;118;103;71;47;37;11;23;0;53,4;46,6;60,2;39,8;52,1;15,5;32,4;0
4;"Arraial do Cabo";"2019";150;96;54;38;58;18;2;18;0;64;36;39,6;60,4;47,4;5,3;47,4;0
5;"Barra do Piraí";"2019";629;325;304;222;103;111;26;85;0;51,7;48,3;68,3;31,7;50;11,7;38,3;0
6;"Barra Mansa";"2019";975;858;117;290;568;202;22;66;0;88;12;33,8;66,2;69,7;7,6;22,8;0
7;"Belford Roxo";"2019";403;365;38;181;184;116;15;50;0;90,6;9,4;49,6;50,4;64,1;8,3;27,6;0
8;"Bom Jardim";"2019";131;36;95;25;11;6;0;19;0;27,5;72,5;69,4;30,6;24;0;76;0
9;"Bom Jesus do Itabapoana";"2019";287;85;202;79;6;11;10;58;0;29,6;70,4;92,9;7,1;13,9;12,7;73,4;0
10;"Cabo Frio";"2019";1176;766;410;481;285;307;45;128;1;65,1;34,9;62,8;37,2;63,8;9,4;26,6;0,2
11;"Cachoeiras de Macacu";"2019";209;178;31;117;61;36;14;64;3;85,2;14,8;65,7;34,3;30,8;12;54,7;2,6
12;"Cambuci";"2019";97;63;34;43;20;21;4;18;0;64,9;35,1;68,3;31,7;48,8;9,3;41,9;0
13;"Campos dos Goytacazes";"2019";2001;714;1287;269;445;89;48;132;0;35,7;64,3;37,7;62,3;33,1;17,8;49,1;0
14;"Cantagalo";"2019";149;66;83;46;20;25;3;17;1;44,3;55,7;69,7;30,3;54,3;6,5;37;2,2
15;"Rio de Janeiro";"2019";30594;26745;3849;15437;11308;4798;3322;5728;1589;87,4;12,6;57,7;42,3;31,1;21,5;37,1;10,3
16;"Carapebus/Quissamã";"2019";177;138;39;25;113;11;3;11;0;78;22;18,1;81,9;44;12;44;0
17;"Carmo";"2019";175;26;149;14;12;0;0;14;0;14,9;85,1;53,8;46,2;0;0;100;0
18;"Casimiro de Abreu";"2019";175;22;153;14;8;3;0;11;0;12,6;87,4;63,6;36,4;21,4;0;78,6;0
19;"Conceição de Macabu";"2019";137;64;73;42;22;23;3;15;1;46,7;53,3;65,6;34,4;54,8;7,1;35,7;2,4
20;"Cordeiro";"2019";215;55;160;54;1;8;6;40;0;25,6;74,4;98,2;1,8;14,8;11,1;74,1;0
21;"Duas Barras";"2019";49;11;38;9;2;1;1;7;0;22,4;77,6;81,8;18,2;11,1;11,1;77,8;0
22;"Duque de Caxias";"2019";4314;3682;632;1240;2442;543;292;394;11;85,4;14,6;33,7;66,3;43,8;23,5;31,8;0,9
23;"Engenheiro Paulo de Frontin";"2019";134;126;8;108;18;79;8;21;0;94;6;85,7;14,3;73,1;7,4;19,4;0
24;"Guapimirim";"2019";240;87;153;71;16;42;6;23;0;36,2;63,8;81,6;18,4;59,2;8,5;32,4;0
25;"Iguaba Grande";"2019";202;50;152;26;24;5;1;20;0;24,8;75,2;52;48;19,2;3,8;76,9;0
26;"Itaboraí";"2019";669;533;136;355;178;224;63;57;11;79,7;20,3;66,6;33,4;63,1;17,7;16,1;3,1
27;"Itaguaí";"2019";722;226;496;93;133;57;6;25;5;31,3;68,7;41,2;58,8;61,3;6,5;26,9;5,4
28;"Italva(Cardoso Moreira)";"2019";143;73;70;50;23;16;1;30;3;51;49;68,5;31,5;32;2;60;6
29;"Itaocara";"2019";217;48;169;40;8;4;2;33;1;22,1;77,9;83,3;16,7;10;5;82,5;2,5
30;"Itaperuna";"2019";562;249;313;130;119;44;5;81;0;44,3;55,7;52,2;47,8;33,8;3,8;62,3;0
31;"Itatiaia";"2019";195;161;34;102;59;69;14;19;0;82,6;17,4;63,4;36,6;67,6;13,7;18,6;0
32;"Japeri";"2019";454;216;238;113;103;42;11;60;0;47,6;52,4;52,3;47,7;37,2;9,7;53,1;0
33;"Laje do Muriaé";"2019";67;56;11;33;23;14;3;15;1;83,6;16,4;58,9;41,1;42,4;9,1;45,5;3
34;"Macaé";"2019";884;387;497;195;192;152;11;31;1;43,8;56,2;50,4;49,6;77,9;5,6;15,9;0,5
35;"Magé";"2019";968;665;303;373;292;127;69;163;14;68,7;31,3;56,1;43,9;34;18,5;43,7;3,8
36;"Mangaratiba";"2019";182;143;39;57;86;26;5;26;0;78,6;21,4;39,9;60,1;45,6;8,8;45,6;0
37;"Maricá";"2019";317;187;130;93;94;65;4;22;2;59;41;49,7;50,3;69,9;4,3;23,7;2,2
38;"Mendes";"2019";128;71;57;60;11;32;7;21;0;55,5;44,5;84,5;15,5;53,3;11,7;35;0
40;"Miguel Pereira";"2019";191;169;22;88;81;34;3;51;0;88,5;11,5;52,1;47,9;38,6;3,4;58;0
41;"Miracema";"2019";375;366;9;267;99;63;14;187;3;97,6;2,4;73;27;23,6;5,2;70;1,1
42;"Natividade";"2019";119;76;43;50;26;11;3;34;2;63,9;36,1;65,8;34,2;22;6;68;4
43;"Nilópolis";"2019";234;219;15;170;49;88;35;43;4;93,6;6,4;77,6;22,4;51,8;20,6;25,3;2,4
44;"Niterói";"2019";2145;1927;218;1297;630;606;225;384;82;89,8;10,2;67,3;32,7;46,7;17,3;29,6;6,3
45;"Nova Friburgo";"2019";1013;805;208;321;484;165;56;97;3;79,5;20,5;39,9;60,1;51,4;17,4;30,2;0,9
46;"Nova Iguaçu";"2019";4355;2608;1747;1198;1410;503;364;322;9;59,9;40,1;45,9;54,1;42;30,4;26,9;0,8
47;"Paracambi";"2019";197;105;92;73;32;32;3;38;0;53,3;46,7;69,5;30,5;43,8;4,1;52,1;0
48;"Paraíba do Sul";"2019";398;287;111;126;161;52;9;65;0;72,1;27,9;43,9;56,1;41,3;7,1;51,6;0
49;"Paraty";"2019";244;212;32;43;169;26;6;11;0;86,9;13,1;20,3;79,7;60,5;14;25,6;0
50;"Paty do Alferes";"2019";139;119;20;43;76;12;3;28;0;85,6;14,4;36,1;63,9;27,9;7;65,1;0
51;"Petrópolis";"2019";2233;1944;289;760;1184;314;93;342;11;87,1;12,9;39,1;60,9;41,3;12,2;45;1,4
52;"Pinheiral";"2019";147;137;10;72;65;35;15;22;0;93,2;6,8;52,6;47,4;48,6;20,8;30,6;0
53;"Piraí";"2019";220;114;106;50;64;30;3;17;0;51,8;48,2;43,9;56,1;60;6;34;0
54;"Porciúncula";"2019";258;201;57;118;83;59;11;48;0;77,9;22,1;58,7;41,3;50;9,3;40,7;0
55;"Porto Real-Quatis";"2019";125;85;40;41;44;32;2;7;0;68;32;48,2;51,8;78;4,9;17,1;0
56;"Queimados";"2019";435;128;307;73;55;44;15;14;0;29,4;70,6;57;43;60,3;20,5;19,2;0
57;"Resende";"2019";873;731;142;305;426;134;22;148;1;83,7;16,3;41,7;58,3;43,9;7,2;48,5;0,3
58;"Rio Bonito";"2019";362;169;193;119;50;75;6;38;0;46,7;53,3;70,4;29,6;63;5;31,9;0
59;"Rio Claro";"2019";154;123;31;59;64;10;8;41;0;79,9;20,1;48;52;16,9;13,6;69,5;0
60;"Rio Das Flores";"2019";56;44;12;32;12;12;3;17;0;78,6;21,4;72,7;27,3;37,5;9,4;53,1;0
61;"Rio Das Ostras";"2019";689;51;638;22;29;4;1;17;0;7,4;92,6;43,1;56,9;18,2;4,5;77,3;0
62;"Santa Maria Madalena";"2019";26;5;21;5;0;0;1;4;0;19,2;80,8;100;0;0;20;80;0
63;"Santo Antônio de Pádua";"2019";426;234;192;177;57;86;5;75;11;54,9;45,1;75,6;24,4;48,6;2,8;42,4;6,2
64;"São Fidélis";"2019";209;28;181;26;2;9;1;16;0;13,4;86,6;92,9;7,1;34,6;3,8;61,5;0
65;"São Francisco do Itabapoana";"2019";205;21;184;19;2;1;0;18;0;10,2;89,8;90,5;9,5;5,3;0;94,7;0
66;"São Gonçalo";"2019";3022;2734;288;1754;980;630;488;372;264;90,5;9,5;64,2;35,8;35,9;27,8;21,2;15,1
67;"São João da Barra";"2019";314;159;155;26;133;7;8;11;0;50,6;49,4;16,4;83,6;26,9;30,8;42,3;0
68;"São João de Meriti";"2019";571;538;33;368;170;269;46;53;0;94,2;5,8;68,4;31,6;73,1;12,5;14,4;0
69;"São José do Vale do Rio Preto";"2019";83;55;28;23;32;6;2;14;1;66,3;33,7;41,8;58,2;26,1;8,7;60,9;4,3
70;"São Pedro da Aldeia";"2019";614;527;87;285;242;112;16;156;1;85,8;14,2;54,1;45,9;39,3;5,6;54,7;0,4
71;"São Sebastião do Alto";"2019";28;10;18;10;0;1;0;9;0;35,7;64,3;100;0;10;0;90;0
72;"Sapucaia";"2019";163;65;98;40;25;5;0;34;1;39,9;60,1;61,5;38,5;12,5;0;85;2,5
73;"Saquarema";"2019";140;125;15;72;53;53;7;12;0;89,3;10,7;57,6;42,4;73,6;9,7;16,7;0
74;"Seropédica";"2019";399;119;280;59;60;38;6;15;0;29,8;70,2;49,6;50,4;64,4;10,2;25,4;0
75;"Silva Jardim";"2019";145;59;86;34;25;18;0;16;0;40,7;59,3;57,6;42,4;52,9;0;47,1;0
76;"Sumidouro";"2019";129;111;18;42;69;11;13;18;0;86;14;37,8;62,2;26,2;31;42,9;0
78;"Teresópolis";"2019";1238;1096;142;333;763;166;56;108;3;88,5;11,5;30,4;69,6;49,8;16,8;32,4;0,9
79;"Trajano de Moraes";"2019";42;7;35;6;1;1;0;3;2;16,7;83,3;85,7;14,3;16,7;0;50;33,3
80;"Três Rios";"2019";892;706;186;427;279;300;36;90;1;79,1;20,9;60,5;39,5;70,3;8,4;21,1;0,2
81;"Valença";"2019";482;408;74;229;179;63;8;155;3;84,6;15,4;56,1;43,9;27,5;3,5;67,7;1,3
82;"Vassouras";"2019";289;265;24;177;88;81;13;83;0;91,7;8,3;66,8;33,2;45,8;7,3;46,9;0
83;"Volta Redonda";"2019";1352;690;662;355;335;180;32;143;0;51;49;51,4;48,6;50,7;9;40,3;0
1;"Angra dos Reis";"2018";584;439;145;279;160;180;37;60;2;75,2;24,8;63,6;36,4;64,5;13,3;21,5;0,7
2;"Araruama";"2018";923;362;561;286;76;148;21;115;2;39,2;60,8;79;21;51,7;7,3;40,2;0,7
3;"Armação dos Búzios";"2018";232;132;100;102;30;65;9;28;0;56,9;43,1;77,3;22,7;63,7;8,8;27,5;0
4;"Arraial do Cabo";"2018";223;93;130;42;51;28;5;9;0;41,7;58,3;45,2;54,8;66,7;11,9;21,4;0
5;"Barra do Piraí";"2018";564;278;286;222;56;121;21;75;5;49,3;50,7;79,9;20,1;54,5;9,5;33,8;2,3
6;"Barra Mansa";"2018";854;745;109;347;398;233;39;74;1;87,2;12,8;46,6;53,4;67,1;11,2;21,3;0,3
7;"Belford Roxo";"2018";482;461;21;343;118;236;20;84;3;95,6;4,4;74,4;25,6;68,8;5,8;24,5;0,9
8;"Bom Jardim";"2018";125;42;83;38;4;8;3;27;0;33,6;66,4;90,5;9,5;21,1;7,9;71,1;0
9;"Bom Jesus do Itabapoana";"2018";307;103;204;101;2;44;11;42;4;33,6;66,4;98,1;1,9;43,6;10,9;41,6;4
10;"Cabo Frio";"2018";1282;645;637;494;151;304;65;122;3;50,3;49,7;76,6;23,4;61,5;13,2;24,7;0,6
11;"Cachoeiras de Macacu";"2018";188;170;18;147;23;73;31;42;1;90,4;9,6;86,5;13,5;49,7;21,1;28,6;0,7
12;"Cambuci";"2018";54;44;10;37;7;22;6;9;0;81,5;18,5;84,1;15,9;59,5;16,2;24,3;0
13;"Campos dos Goytacazes";"2018";1600;570;1030;313;257;132;82;98;1;35,6;64,4;54,9;45,1;42,2;26,2;31,3;0,3
14;"Cantagalo";"2018";145;69;76;53;16;26;6;20;1;47,6;52,4;76,8;23,2;49,1;11,3;37,7;1,9
15;"Rio de Janeiro";"2018";29255;25340;3915;20418;4922;6599;5178;5183;3458;86,6;13,4;80,6;19,4;32,3;25,4;25,4;16,9
16;"Carapebus/Quissamã";"2018";227;125;102;64;61;45;7;12;0;55,1;44,9;51,2;48,8;70,3;10,9;18,8;0
17;"Carmo";"2018";106;23;83;19;4;4;2;13;0;21,7;78,3;82,6;17,4;21,1;10,5;68,4;0
18;"Casimiro de Abreu";"2018";199;37;162;35;2;15;2;18;0;18,6;81,4;94,6;5,4;42,9;5,7;51,4;0
19;"Conceição de Macabu";"2018";88;39;49;35;4;24;1;10;0;44,3;55,7;89,7;10,3;68,6;2,9;28,6;0
20;"Cordeiro";"2018";229;72;157;66;6;22;3;39;2;31,4;68,6;91,7;8,3;33,3;4,5;59,1;3
21;"Duas Barras";"2018";69;38;31;24;14;5;6;12;1;55,1;44,9;63,2;36,8;20,8;25;50;4,2
22;"Duque de Caxias";"2018";5123;4255;868;2492;1763;957;712;711;112;83,1;16,9;58,6;41,4;38,4;28,6;28,5;4,5
23;"Engenheiro Paulo de Frontin";"2018";106;101;5;96;5;65;5;26;0;95,3;4,7;95;5;67,7;5,2;27,1;0
24;"Guapimirim";"2018";352;155;197;140;15;75;26;33;6;44;56;90,3;9,7;53,6;18,6;23,6;4,3
25;"Iguaba Grande";"2018";89;51;38;26;25;10;1;15;0;57,3;42,7;51;49;38,5;3,8;57,7;0
26;"Itaboraí";"2018";880;810;70;612;198;371;121;103;17;92;8;75,6;24,4;60,6;19,8;16,8;2,8
27;"Itaguaí";"2018";564;242;322;158;84;101;27;24;6;42,9;57,1;65,3;34,7;63,9;17,1;15,2;3,8
28;"Italva(Cardoso Moreira)";"2018";136;30;106;27;3;6;1;20;0;22,1;77,9;90;10;22,2;3,7;74,1;0
29;"Itaocara";"2018";195;41;154;40;1;18;5;17;0;21;79;97,6;2,4;45;12,5;42,5;0
30;"Itaperuna";"2018";432;260;172;165;95;92;23;50;0;60,2;39,8;63,5;36,5;55,8;13,9;30,3;0
31;"Itatiaia";"2018";221;206;15;144;62;87;28;29;0;93,2;6,8;69,9;30,1;60,4;19,4;20,1;0
32;"Japeri";"2018";373;154;219;108;46;43;3;61;1;41,3;58,7;70,1;29,9;39,8;2,8;56,5;0,9
33;"Laje do Muriaé";"2018";46;37;9;33;4;8;6;16;3;80,4;19,6;89,2;10,8;24,2;18,2;48,5;9,1
34;"Macaé";"2018";829;380;449;295;85;238;22;30;5;45,8;54,2;77,6;22,4;80,7;7,5;10,2;1,7
35;"Magé";"2018";852;598;254;441;157;181;102;126;32;70,2;29,8;73,7;26,3;41;23,1;28,6;7,3
36;"Mangaratiba";"2018";194;164;30;91;73;51;9;31;0;84,5;15,5;55,5;44,5;56;9,9;34,1;0
37;"Maricá";"2018";235;198;37;150;48;59;12;55;24;84,3;15,7;75,8;24,2;39,3;8;36,7;16
38;"Mendes";"2018";109;65;44;58;7;32;4;17;5;59,6;40,4;89,2;10,8;55,2;6,9;29,3;8,6
40;"Miguel Pereira";"2018";190;144;46;110;34;35;20;55;0;75,8;24,2;76,4;23,6;31,8;18,2;50;0
41;"Miracema";"2018";260;251;9;218;33;111;17;82;8;96,5;3,5;86,9;13,1;50,9;7,8;37,6;3,7
42;"Natividade";"2018";131;110;21;76;34;38;3;30;5;84;16;69,1;30,9;50;3,9;39,5;6,6
43;"Nilópolis";"2018";204;190;14;167;23;94;26;39;8;93,1;6,9;87,9;12,1;56,3;15,6;23,4;4,8
44;"Niterói";"2018";1998;1892;106;1672;220;907;280;310;175;94,7;5,3;88,4;11,6;54,2;16,7;18,5;10,5
45;"Nova Friburgo";"2018";832;615;217;462;153;264;87;103;8;73,9;26,1;75,1;24,9;57,1;18,8;22,3;1,7
46;"Nova Iguaçu";"2018";3907;2590;1317;1539;1051;788;394;330;27;66,3;33,7;59,4;40,6;51,2;25,6;21,4;1,8
47;"Paracambi";"2018";214;78;136;54;24;18;4;32;0;36,4;63,6;69,2;30,8;33,3;7,4;59,3;0
48;"Paraíba do Sul";"2018";409;334;75;197;137;93;9;90;5;81,7;18,3;59;41;47,2;4,6;45,7;2,5
49;"Paraty";"2018";181;139;42;66;73;43;2;20;1;76,8;23,2;47,5;52,5;65,2;3;30,3;1,5
50;"Paty do Alferes";"2018";129;101;28;69;32;17;10;42;0;78,3;21,7;68,3;31,7;24,6;14,5;60,9;0
51;"Petrópolis";"2018";2399;2154;245;1406;748;530;279;547;50;89,8;10,2;65,3;34,7;37,7;19,8;38,9;3,6
52;"Pinheiral";"2018";56;52;4;36;16;24;7;5;0;92,9;7,1;69,2;30,8;66,7;19,4;13,9;0
53;"Piraí";"2018";244;145;99;107;38;70;14;21;2;59,4;40,6;73,8;26,2;65,4;13,1;19,6;1,9
54;"Porciúncula";"2018";186;173;13;140;33;94;18;26;2;93;7;80,9;19,1;67,1;12,9;18,6;1,4
55;"Porto Real-Quatis";"2018";150;100;50;67;33;44;3;17;3;66,7;33,3;67;33;65,7;4,5;25,4;4,5
56;"Queimados";"2018";387;165;222;139;26;96;28;15;0;42,6;57,4;84,2;15,8;69,1;20,1;10,8;0
57;"Resende";"2018";871;721;150;362;359;189;33;140;0;82,8;17,2;50,2;49,8;52,2;9,1;38,7;0
58;"Rio Bonito";"2018";284;181;103;152;29;112;10;30;0;63,7;36,3;84;16;73,7;6,6;19,7;0
59;"Rio Claro";"2018";81;58;23;35;23;7;5;22;1;71,6;28,4;60,3;39,7;20;14,3;62,9;2,9
60;"Rio Das Flores";"2018";71;65;6;54;11;33;10;10;1;91,5;8,5;83,1;16,9;61,1;18,5;18,5;1,9
61;"Rio Das Ostras";"2018";1121;93;1028;56;37;13;3;40;0;8,3;91,7;60,2;39,8;23,2;5,4;71,4;0
62;"Santa Maria Madalena";"2018";52;11;41;11;0;4;1;6;0;21,2;78,8;100;0;36,4;9,1;54,5;0
63;"Santo Antônio de Pádua";"2018";440;257;183;232;25;155;25;44;8;58,4;41,6;90,3;9,7;66,8;10,8;19;3,4
64;"São Fidélis";"2018";180;43;137;42;1;12;5;25;0;23,9;76,1;97,7;2,3;28,6;11,9;59,5;0
65;"São Francisco do Itabapoana";"2018";148;10;138;10;0;3;2;5;0;6,8;93,2;100;0;30;20;50;0
66;"São Gonçalo";"2018";2789;2312;477;1957;355;853;574;263;267;82,9;17,1;84,6;15,4;43,6;29,3;13,4;13,6
67;"São João da Barra";"2018";234;18;216;6;12;3;0;3;0;7,7;92,3;33,3;66,7;50;0;50;0
68;"São João de Meriti";"2018";592;576;16;476;100;385;49;38;4;97,3;2,7;82,6;17,4;80,9;10,3;8;0,8
69;"São José do Vale do Rio Preto";"2018";80;44;36;40;4;14;4;20;2;55;45;90,9;9,1;35;10;50;5
70;"São Pedro da Aldeia";"2018";457;392;65;279;113;145;20;105;9;85,8;14,2;71,2;28,8;52;7,2;37,6;3,2
71;"São Sebastião do Alto";"2018";34;10;24;9;1;2;2;5;0;29,4;70,6;90;10;22,2;22,2;55,6;0
72;"Sapucaia";"2018";156;98;58;80;18;31;7;41;1;62,8;37,2;81,6;18,4;38,8;8,8;51,2;1,2
73;"Saquarema";"2018";118;108;10;70;38;50;4;16;0;91,5;8,5;64,8;35,2;71,4;5,7;22,9;0
74;"Seropédica";"2018";253;120;133;91;29;62;3;26;0;47,4;52,6;75,8;24,2;68,1;3,3;28,6;0
75;"Silva Jardim";"2018";97;63;34;47;16;21;3;23;0;64,9;35,1;74,6;25,4;44,7;6,4;48,9;0
76;"Sumidouro";"2018";75;62;13;43;19;22;11;10;0;82,7;17,3;69,4;30,6;51,2;25,6;23,3;0
78;"Teresópolis";"2018";970;876;94;573;303;229;222;109;13;90,3;9,7;65,4;34,6;40;38,7;19;2,3
79;"Trajano de Moraes";"2018";45;12;33;12;0;4;2;6;0;26,7;73,3;100;0;33,3;16,7;50;0
80;"Três Rios";"2018";1003;865;138;685;180;438;85;149;13;86,2;13,8;79,2;20,8;63,9;12,4;21,8;1,9
81;"Valença";"2018";426;375;51;262;113;139;19;99;5;88;12;69,9;30,1;53,1;7,3;37,8;1,9
82;"Vassouras";"2018";173;164;9;144;20;93;5;46;0;94,8;5,2;87,8;12,2;64,6;3,5;31,9;0
83;"Volta Redonda";"2018";1071;636;435;406;230;285;43;78;0;59,4;40,6;63,8;36,2;70,2;10,6;19,2;0
1;"Angra dos Reis";"2017";615;409;206;327;82;186;36;101;4;66,5;33,5;80;20;56,9;11;30,9;1,2
2;"Araruama";"2017";722;318;404;275;43;175;21;77;2;44;56;86,5;13,5;63,6;7,6;28;0,7
3;"Armação dos Búzios";"2017";339;192;147;144;48;77;18;48;1;56,6;43,4;75;25;53,5;12,5;33,3;0,7
4;"Arraial do Cabo";"2017";141;86;55;47;39;28;9;10;0;61;39;54,7;45,3;59,6;19,1;21,3;0
5;"Barra do Piraí";"2017";476;250;226;215;35;125;30;57;3;52,5;47,5;86;14;58,1;14;26,5;1,4
6;"Barra Mansa";"2017";625;561;64;334;227;215;39;80;0;89,8;10,2;59,5;40,5;64,4;11,7;24;0
7;"Belford Roxo";"2017";435;413;22;328;85;222;39;67;0;94,9;5,1;79,4;20,6;67,7;11,9;20,4;0
8;"Bom Jardim";"2017";86;27;59;25;2;4;4;17;0;31,4;68,6;92,6;7,4;16;16;68;0
9;"Bom Jesus do Itabapoana";"2017";313;157;156;157;0;67;21;62;7;50,2;49,8;100;0;42,7;13,4;39,5;4,5
10;"Cabo Frio";"2017";743;591;152;536;55;354;83;96;3;79,5;20,5;90,7;9,3;66;15,5;17,9;0,6
11;"Cachoeiras de Macacu";"2017";309;264;45;248;16;101;48;87;12;85,4;14,6;93,9;6,1;40,7;19,4;35,1;4,8
12;"Cambuci";"2017";36;28;8;24;4;12;3;9;0;77,8;22,2;85,7;14,3;50;12,5;37,5;0
13;"Campos dos Goytacazes";"2017";1482;479;1003;311;168;112;85;109;5;32,3;67,7;64,9;35,1;36;27,3;35;1,6
14;"Cantagalo";"2017";148;83;65;73;10;36;3;27;7;56,1;43,9;88;12;49,3;4,1;37;9,6
15;"Rio de Janeiro";"2017";26848;22462;4386;19818;2644;6996;4799;4967;3056;83,7;16,3;88,2;11,8;35,3;24,2;25,1;15,4
16;"Carapebus/Quissamã";"2017";172;93;79;76;17;40;10;23;3;54,1;45,9;81,7;18,3;52,6;13,2;30,3;3,9
17;"Carmo";"2017";101;26;75;25;1;3;1;21;0;25,7;74,3;96,2;3,8;12;4;84;0
18;"Casimiro de Abreu";"2017";164;39;125;36;3;12;7;17;0;23,8;76,2;92,3;7,7;33,3;19,4;47,2;0
19;"Conceição de Macabu";"2017";62;52;10;49;3;29;7;10;3;83,9;16,1;94,2;5,8;59,2;14,3;20,4;6,1
20;"Cordeiro";"2017";231;90;141;89;1;35;3;46;5;39;61;98,9;1,1;39,3;3,4;51,7;5,6
21;"Duas Barras";"2017";55;33;22;25;8;7;3;14;1;60;40;75,8;24,2;28;12;56;4
22;"Duque de Caxias";"2017";4075;2912;1163;2373;539;1037;551;570;215;71,5;28,5;81,5;18,5;43,7;23,2;24;9,1
23;"Engenheiro Paulo de Frontin";"2017";91;86;5;79;7;47;10;20;2;94,5;5,5;91,9;8,1;59,5;12,7;25,3;2,5
24;"Guapimirim";"2017";374;242;132;235;7;145;31;43;16;64,7;35,3;97,1;2,9;61,7;13,2;18,3;6,8
25;"Iguaba Grande";"2017";96;52;44;38;14;7;8;22;1;54,2;45,8;73,1;26,9;18,4;21,1;57,9;2,6
26;"Itaboraí";"2017";672;582;90;512;70;332;81;88;11;86,6;13,4;88;12;64,8;15,8;17,2;2,1
27;"Itaguaí";"2017";585;186;399;161;25;119;7;25;10;31,8;68,2;86,6;13,4;73,9;4,3;15,5;6,2
28;"Italva(Cardoso Moreira)";"2017";141;51;90;50;1;13;1;34;2;36,2;63,8;98;2;26;2;68;4
29;"Itaocara";"2017";182;43;139;40;3;21;4;15;0;23,6;76,4;93;7;52,5;10;37,5;0
30;"Itaperuna";"2017";590;314;276;246;68;121;61;64;0;53,2;46,8;78,3;21,7;49,2;24,8;26;0
31;"Itatiaia";"2017";258;194;64;156;38;89;29;37;1;75,2;24,8;80,4;19,6;57,1;18,6;23,7;0,6
32;"Japeri";"2017";263;162;101;127;35;56;5;65;1;61,6;38,4;78,4;21,6;44,1;3,9;51,2;0,8
33;"Laje do Muriaé";"2017";46;37;9;34;3;16;3;12;3;80,4;19,6;91,9;8,1;47,1;8,8;35,3;8,8
34;"Macaé";"2017";677;342;335;305;37;232;28;39;6;50,5;49,5;89,2;10,8;76,1;9,2;12,8;2
35;"Magé";"2017";870;621;249;527;94;285;92;114;36;71,4;28,6;84,9;15,1;54,1;17,5;21,6;6,8
36;"Mangaratiba";"2017";174;159;15;103;56;60;13;29;1;91,4;8,6;64,8;35,2;58,3;12,6;28,2;1
37;"Maricá";"2017";483;286;197;244;42;159;22;41;22;59,2;40,8;85,3;14,7;65,2;9;16,8;9
38;"Mendes";"2017";110;63;47;61;2;42;1;16;2;57,3;42,7;96,8;3,2;68,9;1,6;26,2;3,3
40;"Miguel Pereira";"2017";131;56;75;54;2;26;5;21;2;42,7;57,3;96,4;3,6;48,1;9,3;38,9;3,7
41;"Miracema";"2017";182;167;15;164;3;72;25;58;9;91,8;8,2;98,2;1,8;43,9;15,2;35,4;5,5
42;"Natividade";"2017";147;131;16;105;26;44;9;51;1;89,1;10,9;80,2;19,8;41,9;8,6;48,6;1
43;"Nilópolis";"2017";233;230;3;205;25;124;47;31;3;98,7;1,3;89,1;10,9;60,5;22,9;15,1;1,5
44;"Niterói";"2017";1884;1755;129;1629;126;839;280;374;136;93,2;6,8;92,8;7,2;51,5;17,2;23;8,3
45;"Nova Friburgo";"2017";915;653;262;588;65;285;125;153;25;71,4;28,6;90;10;48,5;21,3;26;4,3
46;"Nova Iguaçu";"2017";3342;2408;934;1893;515;937;451;459;46;72,1;27,9;78,6;21,4;49,5;23,8;24,2;2,4
47;"Paracambi";"2017";244;87;157;76;11;5;7;64;0;35,7;64,3;87,4;12,6;6,6;9,2;84,2;0
48;"Paraíba do Sul";"2017";308;244;64;189;55;76;23;85;5;79,2;20,8;77,5;22,5;40,2;12,2;45;2,6
49;"Paraty";"2017";217;190;27;117;73;66;15;33;3;87,6;12,4;61,6;38,4;56,4;12,8;28,2;2,6
50;"Paty do Alferes";"2017";96;34;62;30;4;15;5;10;0;35,4;64,6;88,2;11,8;50;16,7;33,3;0
51;"Petrópolis";"2017";1841;1737;104;1415;322;552;331;484;48;94,4;5,6;81,5;18,5;39;23,4;34,2;3,4
52;"Pinheiral";"2017";77;66;11;60;6;32;15;11;2;85,7;14,3;90,9;9,1;53,3;25;18,3;3,3
53;"Piraí";"2017";232;127;105;109;18;59;7;34;9;54,7;45,3;85,8;14,2;54,1;6,4;31,2;8,3
54;"Porciúncula";"2017";155;145;10;134;11;61;38;32;3;93,5;6,5;92,4;7,6;45,5;28,4;23,9;2,2
55;"Porto Real-Quatis";"2017";153;125;28;97;28;62;11;21;3;81,7;18,3;77,6;22,4;63,9;11,3;21,6;3,1
56;"Queimados";"2017";353;168;185;150;18;107;23;20;0;47,6;52,4;89,3;10,7;71,3;15,3;13,3;0
57;"Resende";"2017";943;766;177;405;361;243;55;106;1;81,2;18,8;52,9;47,1;60;13,6;26,2;0,2
58;"Rio Bonito";"2017";288;160;128;152;8;108;10;32;2;55,6;44,4;95;5;71,1;6,6;21,1;1,3
59;"Rio Claro";"2017";124;102;22;81;21;33;21;24;3;82,3;17,7;79,4;20,6;40,7;25,9;29,6;3,7
60;"Rio Das Flores";"2017";47;45;2;39;6;19;5;13;2;95,7;4,3;86,7;13,3;48,7;12,8;33,3;5,1
61;"Rio Das Ostras";"2017";661;135;526;101;34;17;17;64;3;20,4;79,6;74,8;25,2;16,8;16,8;63,4;3
62;"Santa Maria Madalena";"2017";54;5;49;5;0;0;1;3;1;9,3;90,7;100;0;0;20;60;20
63;"Santo Antônio de Pádua";"2017";306;208;98;201;7;108;12;65;16;68;32;96,6;3,4;53,7;6;32,3;8
64;"São Fidélis";"2017";137;22;115;21;1;8;2;11;0;16,1;83,9;95,5;4,5;38,1;9,5;52,4;0
65;"São Francisco do Itabapoana";"2017";100;14;86;12;2;5;3;4;0;14;86;85,7;14,3;41,7;25;33,3;0
66;"São Gonçalo";"2017";2432;2229;203;2044;185;890;525;343;286;91,7;8,3;91,7;8,3;43,5;25,7;16,8;14
67;"São João da Barra";"2017";192;13;179;10;3;5;2;3;0;6,8;93,2;76,9;23,1;50;20;30;0
68;"São João de Meriti";"2017";624;599;25;520;79;420;38;60;2;96;4;86,8;13,2;80,8;7,3;11,5;0,4
69;"São José do Vale do Rio Preto";"2017";77;48;29;41;7;17;8;15;1;62,3;37,7;85,4;14,6;41,5;19,5;36,6;2,4
70;"São Pedro da Aldeia";"2017";288;260;28;240;20;143;21;72;4;90,3;9,7;92,3;7,7;59,6;8,8;30;1,7
71;"São Sebastião do Alto";"2017";25;17;8;15;2;2;0;12;1;68;32;88,2;11,8;13,3;0;80;6,7
72;"Sapucaia";"2017";116;65;51;58;7;25;8;22;3;56;44;89,2;10,8;43,1;13,8;37,9;5,2
73;"Saquarema";"2017";148;138;10;103;35;68;8;27;0;93,2;6,8;74,6;25,4;66;7,8;26,2;0
74;"Seropédica";"2017";264;133;131;110;23;55;14;38;3;50,4;49,6;82,7;17,3;50;12,7;34,5;2,7
75;"Silva Jardim";"2017";79;42;37;37;5;19;5;13;0;53,2;46,8;88,1;11,9;51,4;13,5;35,1;0
76;"Sumidouro";"2017";62;54;8;39;15;13;12;13;1;87,1;12,9;72,2;27,8;33,3;30,8;33,3;2,6
78;"Teresópolis";"2017";1010;557;453;432;125;107;179;120;26;55,1;44,9;77,6;22,4;24,8;41,4;27,8;6
79;"Trajano de Moraes";"2017";32;9;23;7;2;0;1;6;0;28,1;71,9;77,8;22,2;0;14,3;85,7;0
80;"Três Rios";"2017";750;680;70;585;95;362;70;131;22;90,7;9,3;86;14;61,9;12;22,4;3,8
81;"Valença";"2017";440;408;32;355;53;193;33;122;7;92,7;7,3;87;13;54,4;9,3;34,4;2
82;"Vassouras";"2017";147;129;18;122;7;79;17;21;5;87,8;12,2;94,6;5,4;64,8;13,9;17,2;4,1
83;"Volta Redonda";"2017";959;647;312;454;193;312;42;98;2;67,5;32,5;70,2;29,8;68,7;9,3;21,6;0,4
1;"Angra dos Reis";"2016";1069;559;510;449;110;208;36;194;11;52,3;47,7;80,3;19,7;46,3;8;43,2;2,4
2;"Araruama";"2016";511;280;231;250;30;135;32;80;3;54,8;45,2;89,3;10,7;54;12,8;32;1,2
3;"Armação dos Búzios";"2016";422;250;172;189;61;99;30;58;2;59,2;40,8;75,6;24,4;52,4;15,9;30,7;1,1
4;"Arraial do Cabo";"2016";137;71;66;46;25;32;3;10;1;51,8;48,2;64,8;35,2;69,6;6,5;21,7;2,2
5;"Barra do Piraí";"2016";443;333;110;276;57;152;33;77;14;75,2;24,8;82,9;17,1;55,1;12;27,9;5,1
6;"Barra Mansa";"2016";594;491;103;358;133;210;74;69;5;82,7;17,3;72,9;27,1;58,7;20,7;19,3;1,4
7;"Belford Roxo";"2016";463;439;24;384;55;251;58;72;3;94,8;5,2;87,5;12,5;65,4;15,1;18,8;0,8
8;"Bom Jardim";"2016";99;27;72;26;1;7;4;15;0;27,3;72,7;96,3;3,7;26,9;15,4;57,7;0
9;"Bom Jesus do Itabapoana";"2016";203;68;135;68;0;31;7;27;3;33,5;66,5;100;0;45,6;10,3;39,7;4,4
10;"Cabo Frio";"2016";1014;839;175;768;71;424;150;175;19;82,7;17,3;91,5;8,5;55,2;19,5;22,8;2,5
11;"Cachoeiras de Macacu";"2016";198;153;45;144;9;94;18;28;4;77,3;22,7;94,1;5,9;65,3;12,5;19,4;2,8
12;"Cambuci";"2016";44;26;18;24;2;13;3;8;0;59,1;40,9;92,3;7,7;54,2;12,5;33,3;0
13;"Campos dos Goytacazes";"2016";1718;628;1090;506;122;143;190;156;17;36,6;63,4;80,6;19,4;28,3;37,5;30,8;3,4
14;"Cantagalo";"2016";118;56;62;54;2;20;3;25;6;47,5;52,5;96,4;3,6;37;5,6;46,3;11,1
15;"Rio de Janeiro";"2016";27330;19757;7573;18043;1714;7339;3438;4632;2634;72,3;27,7;91,3;8,7;40,7;19,1;25,7;14,6
16;"Carapebus/Quissamã";"2016";210;86;124;79;7;47;8;23;1;41;59;91,9;8,1;59,5;10,1;29,1;1,3
17;"Carmo";"2016";75;20;55;18;2;0;3;15;0;26,7;73,3;90;10;0;16,7;83,3;0
18;"Casimiro de Abreu";"2016";153;23;130;21;2;9;3;9;0;15;85;91,3;8,7;42,9;14,3;42,9;0
19;"Conceição de Macabu";"2016";58;51;7;47;4;23;6;18;0;87,9;12,1;92,2;7,8;48,9;12,8;38,3;0
20;"Cordeiro";"2016";162;37;125;37;0;20;1;16;0;22,8;77,2;100;0;54,1;2,7;43,2;0
21;"Duas Barras";"2016";47;34;13;28;6;5;5;16;2;72,3;27,7;82,4;17,6;17,9;17,9;57,1;7,1
22;"Duque de Caxias";"2016";3745;2163;1582;1892;271;959;296;485;152;57,8;42,2;87,5;12,5;50,7;15,6;25,6;8
23;"Engenheiro Paulo de Frontin";"2016";92;84;8;77;7;48;15;10;4;91,3;8,7;91,7;8,3;62,3;19,5;13;5,2
24;"Guapimirim";"2016";405;385;20;374;11;168;81;98;27;95,1;4,9;97,1;2,9;44,9;21,7;26,2;7,2
25;"Iguaba Grande";"2016";144;72;72;53;19;20;4;28;1;50;50;73,6;26,4;37,7;7,5;52,8;1,9
26;"Itaboraí";"2016";824;621;203;572;49;374;72;113;13;75,4;24,6;92,1;7,9;65,4;12,6;19,8;2,3
27;"Itaguaí";"2016";812;250;562;217;33;160;17;36;4;30,8;69,2;86,8;13,2;73,7;7,8;16,6;1,8
28;"Italva(Cardoso Moreira)";"2016";174;54;120;53;1;16;2;27;8;31;69;98,1;1,9;30,2;3,8;50,9;15,1
29;"Itaocara";"2016";105;28;77;28;0;11;8;7;2;26,7;73,3;100;0;39,3;28,6;25;7,1
30;"Itaperuna";"2016";673;448;225;386;62;131;111;143;1;66,6;33,4;86,2;13,8;33,9;28,8;37;0,3
31;"Itatiaia";"2016";235;207;28;180;27;81;29;69;1;88,1;11,9;87;13;45;16,1;38,3;0,6
32;"Japeri";"2016";281;222;59;187;35;110;19;58;0;79;21;84,2;15,8;58,8;10,2;31;0
33;"Laje do Muriaé";"2016";49;41;8;38;3;17;5;11;5;83,7;16,3;92,7;7,3;44,7;13,2;28,9;13,2
34;"Macaé";"2016";629;402;227;372;30;276;37;50;9;63,9;36,1;92,5;7,5;74,2;9,9;13,4;2,4
35;"Magé";"2016";929;693;236;609;84;316;110;144;39;74,6;25,4;87,9;12,1;51,9;18,1;23,6;6,4
36;"Mangaratiba";"2016";396;289;107;190;99;72;28;85;5;73;27;65,7;34,3;37,9;14,7;44,7;2,6
37;"Maricá";"2016";489;413;76;352;61;180;44;114;14;84,5;15,5;85,2;14,8;51,1;12,5;32,4;4
38;"Mendes";"2016";102;63;39;63;0;37;3;18;5;61,8;38,2;100;0;58,7;4,8;28,6;7,9
40;"Miguel Pereira";"2016";108;29;79;27;2;4;1;19;3;26,9;73,1;93,1;6,9;14,8;3,7;70,4;11,1
41;"Miracema";"2016";243;194;49;191;3;77;19;85;10;79,8;20,2;98,5;1,5;40,3;9,9;44,5;5,2
42;"Natividade";"2016";151;139;12;126;13;40;18;66;2;92,1;7,9;90,6;9,4;31,7;14,3;52,4;1,6
43;"Nilópolis";"2016";197;191;6;175;16;107;31;27;10;97;3;91,6;8,4;61,1;17,7;15,4;5,7
44;"Niterói";"2016";2061;1904;157;1829;75;897;250;501;181;92,4;7,6;96,1;3,9;49;13,7;27,4;9,9
45;"Nova Friburgo";"2016";883;586;297;542;44;338;77;101;26;66,4;33,6;92,5;7,5;62,4;14,2;18,6;4,8
46;"Nova Iguaçu";"2016";3233;1993;1240;1703;290;903;361;412;27;61,6;38,4;85,4;14,6;53;21,2;24,2;1,6
47;"Paracambi";"2016";187;65;122;58;7;16;1;41;0;34,8;65,2;89,2;10,8;27,6;1,7;70,7;0
48;"Paraíba do Sul";"2016";281;195;86;150;45;53;25;67;5;69,4;30,6;76,9;23,1;35,3;16,7;44,7;3,3
49;"Paraty";"2016";190;180;10;129;51;66;17;40;6;94,7;5,3;71,7;28,3;51,2;13,2;31;4,7
50;"Paty do Alferes";"2016";85;44;41;42;2;21;4;17;0;51,8;48,2;95,5;4,5;50;9,5;40,5;0
51;"Petrópolis";"2016";1673;1183;490;1048;135;448;137;447;16;70,7;29,3;88,6;11,4;42,7;13,1;42,7;1,5
52;"Pinheiral";"2016";67;56;11;55;1;29;8;18;0;83,6;16,4;98,2;1,8;52,7;14,5;32,7;0
53;"Piraí";"2016";291;157;134;147;10;88;14;40;5;54;46;93,6;6,4;59,9;9,5;27,2;3,4
54;"Porciúncula";"2016";156;150;6;141;9;69;32;38;2;96,2;3,8;94;6;48,9;22,7;27;1,4
55;"Porto Real-Quatis";"2016";161;103;58;77;26;43;3;30;1;64;36;74,8;25,2;55,8;3,9;39;1,3
56;"Queimados";"2016";336;199;137;186;13;119;33;34;0;59,2;40,8;93,5;6,5;64;17,7;18,3;0
57;"Resende";"2016";937;816;121;494;322;273;47;171;3;87,1;12,9;60,5;39,5;55,3;9,5;34,6;0,6
58;"Rio Bonito";"2016";318;180;138;173;7;111;9;51;2;56,6;43,4;96,1;3,9;64,2;5,2;29,5;1,2
59;"Rio Claro";"2016";57;57;0;49;8;20;6;20;3;100;0;86;14;40,8;12,2;40,8;6,1
60;"Rio Das Flores";"2016";45;43;2;41;2;22;5;14;0;95,6;4,4;95,3;4,7;53,7;12,2;34,1;0
61;"Rio Das Ostras";"2016";647;65;582;52;13;11;9;32;0;10;90;80;20;21,2;17,3;61,5;0
62;"Santa Maria Madalena";"2016";35;6;29;6;0;0;0;6;0;17,1;82,9;100;0;0;0;100;0
63;"Santo Antônio de Pádua";"2016";254;184;70;181;3;104;18;47;12;72,4;27,6;98,4;1,6;57,5;9,9;26;6,6
64;"São Fidélis";"2016";215;56;159;54;2;19;6;29;0;26;74;96,4;3,6;35,2;11,1;53,7;0
65;"São Francisco do Itabapoana";"2016";73;7;66;7;0;1;1;5;0;9,6;90,4;100;0;14,3;14,3;71,4;0
66;"São Gonçalo";"2016";2838;2136;702;2034;102;1040;473;317;204;75,3;24,7;95,2;4,8;51,1;23,3;15,6;10
67;"São João da Barra";"2016";200;7;193;6;1;1;1;4;0;3,5;96,5;85,7;14,3;16,7;16,7;66,7;0
68;"São João de Meriti";"2016";663;648;15;608;40;504;28;69;7;97,7;2,3;93,8;6,2;82,9;4,6;11,3;1,2
69;"São José do Vale do Rio Preto";"2016";50;30;20;26;4;9;1;14;2;60;40;86,7;13,3;34,6;3,8;53,8;7,7
70;"São Pedro da Aldeia";"2016";251;240;11;229;11;135;12;79;3;95,6;4,4;95,4;4,6;59;5,2;34,5;1,3
71;"São Sebastião do Alto";"2016";27;27;0;26;1;4;0;21;1;100;0;96,3;3,7;15,4;0;80,8;3,8
72;"Sapucaia";"2016";187;127;60;124;3;32;27;59;6;67,9;32,1;97,6;2,4;25,8;21,8;47,6;4,8
73;"Saquarema";"2016";121;108;13;91;17;57;7;26;1;89,3;10,7;84,3;15,7;62,6;7,7;28,6;1,1
74;"Seropédica";"2016";195;127;68;103;24;66;12;22;3;65,1;34,9;81,1;18,9;64,1;11,7;21,4;2,9
75;"Silva Jardim";"2016";97;36;61;30;6;16;5;9;0;37,1;62,9;83,3;16,7;53,3;16,7;30;0
76;"Sumidouro";"2016";52;43;9;37;6;12;12;11;2;82,7;17,3;86;14;32,4;32,4;29,7;5,4
78;"Teresópolis";"2016";1205;461;744;381;80;143;134;93;11;38,3;61,7;82,6;17,4;37,5;35,2;24,4;2,9
79;"Trajano de Moraes";"2016";23;13;10;11;2;4;0;7;0;56,5;43,5;84,6;15,4;36,4;0;63,6;0
80;"Três Rios";"2016";785;740;45;657;83;379;90;179;9;94,3;5,7;88,8;11,2;57,7;13,7;27,2;1,4
81;"Valença";"2016";425;365;60;338;27;204;37;91;6;85,9;14,1;92,6;7,4;60,4;10,9;26,9;1,8
82;"Vassouras";"2016";202;129;73;123;6;71;14;28;10;63,9;36,1;95,3;4,7;57,7;11,4;22,8;8,1
83;"Volta Redonda";"2016";892;590;302;456;134;305;44;104;3;66,1;33,9;77,3;22,7;66,9;9,6;22,8;0,7
