"codigo_comarca";"nome_comarca";"ano";"novos";"denuncias";"arquivamentos";"finalizados";"taxa_denuncia";"taxa_arquivamento";"taxa_finalizacao"
1;"Angra dos Reis";2021;72;0;0;0;0;0;0
2;"Araruama";2021;17;0;0;0;0;0;0
3;"Armação dos Búzios";2021;32;6;1;7;18,8;3,1;21,9
4;"Arraial do Cabo";2021;11;0;0;0;0;0;0
5;"Barra do Piraí";2021;149;4;6;10;2,7;4;6,7
6;"Barra Mansa";2021;109;0;0;0;0;0;0
7;"Belford Roxo";2021;25;0;0;0;0;0;0
8;"Bom Jardim";2021;14;1;0;1;7,1;0;7,1
9;"Bom Jesus do Itabapoana";2021;45;0;1;1;0;2,2;2,2
10;"Cabo Frio";2021;94;0;1;1;0;1,1;1,1
11;"Cachoeiras de Macacu";2021;79;1;0;1;1,3;0;1,3
12;"Cambuci";2021;13;1;1;2;7,7;7,7;15,4
13;"Campos dos Goytacazes";2021;87;1;0;1;1,1;0;1,1
14;"Cantagalo";2021;35;0;3;3;0;8,6;8,6
15;"Rio de Janeiro";2021;4035;244;68;312;6;1,7;7,7
16;"Carapebus/Quissamã";2021;63;0;0;0;0;0;0
17;"Carmo";2021;12;1;2;3;8,3;16,7;25
18;"Casimiro de Abreu";2021;25;0;1;1;0;4;4
19;"Conceição de Macabu";2021;6;0;0;0;0;0;0
20;"Cordeiro";2021;34;0;0;0;0;0;0
21;"Duas Barras";2021;10;0;0;0;0;0;0
22;"Duque de Caxias";2021;1074;13;9;22;1,2;0,8;2
23;"Engenheiro Paulo de Frontin";2021;9;0;1;1;0;11,1;11,1
24;"Guapimirim";2021;20;1;0;1;5;0;5
25;"Iguaba Grande";2021;48;0;0;0;0;0;0
26;"Itaboraí";2021;31;0;0;0;0;0;0
27;"Itaguaí";2021;31;1;0;1;3,2;0;3,2
28;"Italva(Cardoso Moreira)";2021;15;0;1;1;0;6,7;6,7
29;"Itaocara";2021;22;4;0;4;18,2;0;18,2
30;"Itaperuna";2021;33;1;1;2;3;3;6,1
31;"Itatiaia";2021;29;4;3;7;13,8;10,3;24,1
32;"Japeri";2021;119;6;0;6;5;0;5
33;"Laje do Muriaé";2021;16;1;1;2;6,2;6,2;12,5
34;"Macaé";2021;127;0;2;2;0;1,6;1,6
35;"Magé";2021;113;3;6;9;2,7;5,3;8
36;"Mangaratiba";2021;139;6;16;22;4,3;11,5;15,8
37;"Maricá";2021;50;0;0;0;0;0;0
38;"Mendes";2021;10;0;2;2;0;20;20
40;"Miguel Pereira";2021;52;2;0;2;3,8;0;3,8
41;"Miracema";2021;32;2;4;6;6,2;12,5;18,8
42;"Natividade";2021;10;0;0;0;0;0;0
43;"Nilópolis";2021;12;0;0;0;0;0;0
44;"Niterói";2021;464;8;9;17;1,7;1,9;3,7
45;"Nova Friburgo";2021;207;1;28;29;0,5;13,5;14
46;"Nova Iguaçu";2021;674;27;23;50;4;3,4;7,4
47;"Paracambi";2021;25;9;1;10;36;4;40
48;"Paraíba do Sul";2021;63;5;3;8;7,9;4,8;12,7
49;"Paraty";2021;9;0;0;0;0;0;0
50;"Paty do Alferes";2021;27;1;0;1;3,7;0;3,7
51;"Petrópolis";2021;216;10;4;14;4,6;1,9;6,5
52;"Pinheiral";2021;23;2;4;6;8,7;17,4;26,1
53;"Piraí";2021;26;5;1;6;19,2;3,8;23,1
54;"Porciúncula";2021;40;3;1;4;7,5;2,5;10
55;"Porto Real-Quatis";2021;9;0;0;0;0;0;0
56;"Queimados";2021;22;8;1;9;36,4;4,5;40,9
57;"Resende";2021;96;13;8;21;13,5;8,3;21,9
58;"Rio Bonito";2021;52;3;1;4;5,8;1,9;7,7
59;"Rio Claro";2021;11;0;1;1;0;9,1;9,1
60;"Rio Das Flores";2021;2;0;0;0;0;0;0
61;"Rio Das Ostras";2021;39;1;5;6;2,6;12,8;15,4
62;"Santa Maria Madalena";2021;12;0;0;0;0;0;0
63;"Santo Antônio de Pádua";2021;131;0;3;3;0;2,3;2,3
64;"São Fidélis";2021;14;0;0;0;0;0;0
65;"São Francisco do Itabapoana";2021;31;0;0;0;0;0;0
66;"São Gonçalo";2021;337;5;3;8;1,5;0,9;2,4
67;"São João da Barra";2021;42;1;3;4;2,4;7,1;9,5
68;"São João de Meriti";2021;15;0;9;9;0;60;60
69;"São José do Vale do Rio Preto";2021;2;0;0;0;0;0;0
70;"São Pedro da Aldeia";2021;55;0;0;0;0;0;0
71;"São Sebastião do Alto";2021;2;0;0;0;0;0;0
72;"Sapucaia";2021;15;0;2;2;0;13,3;13,3
74;"Seropédica";2021;28;2;0;2;7,1;0;7,1
75;"Silva Jardim";2021;31;0;2;2;0;6,5;6,5
76;"Sumidouro";2021;8;0;2;2;0;25;25
78;"Teresópolis";2021;95;0;0;0;0;0;0
79;"Trajano de Moraes";2021;13;0;0;0;0;0;0
80;"Três Rios";2021;41;6;2;8;14,6;4,9;19,5
81;"Valença";2021;88;0;4;4;0;4,5;4,5
82;"Vassouras";2021;21;0;1;1;0;4,8;4,8
83;"Volta Redonda";2021;72;0;3;3;0;4,2;4,2
1;"Angra dos Reis";2020;1210;38;38;76;3,1;3,1;6,3
2;"Araruama";2020;1869;333;95;428;17,8;5,1;22,9
3;"Armação dos Búzios";2020;759;47;27;74;6,2;3,6;9,7
4;"Arraial do Cabo";2020;224;26;8;34;11,6;3,6;15,2
5;"Barra do Piraí";2020;1295;57;239;296;4,4;18,5;22,9
6;"Barra Mansa";2020;1357;191;108;299;14,1;8;22
7;"Belford Roxo";2020;452;0;1;1;0;0,2;0,2
8;"Bom Jardim";2020;181;21;20;41;11,6;11;22,7
9;"Bom Jesus do Itabapoana";2020;326;40;48;88;12,3;14,7;27
10;"Cabo Frio";2020;1625;281;233;514;17,3;14,3;31,6
11;"Cachoeiras de Macacu";2020;418;40;48;88;9,6;11,5;21,1
12;"Cambuci";2020;200;5;25;30;2,5;12,5;15
13;"Campos dos Goytacazes";2020;2484;431;70;501;17,4;2,8;20,2
14;"Cantagalo";2020;266;28;49;77;10,5;18,4;28,9
15;"Rio de Janeiro";2020;38054;6866;2891;9757;18;7,6;25,6
16;"Carapebus/Quissamã";2020;469;24;76;100;5,1;16,2;21,3
17;"Carmo";2020;415;48;113;161;11,6;27,2;38,8
18;"Casimiro de Abreu";2020;439;51;19;70;11,6;4,3;15,9
19;"Conceição de Macabu";2020;302;22;51;73;7,3;16,9;24,2
20;"Cordeiro";2020;318;48;59;107;15,1;18,6;33,6
21;"Duas Barras";2020;105;6;6;12;5,7;5,7;11,4
22;"Duque de Caxias";2020;9907;1897;1216;3113;19,1;12,3;31,4
23;"Engenheiro Paulo de Frontin";2020;162;14;33;47;8,6;20,4;29
24;"Guapimirim";2020;292;53;23;76;18,2;7,9;26
25;"Iguaba Grande";2020;292;47;23;70;16,1;7,9;24
26;"Itaboraí";2020;861;137;70;207;15,9;8,1;24
27;"Itaguaí";2020;771;154;102;256;20;13,2;33,2
28;"Italva(Cardoso Moreira)";2020;425;40;53;93;9,4;12,5;21,9
29;"Itaocara";2020;324;70;66;136;21,6;20,4;42
30;"Itaperuna";2020;1218;82;76;158;6,7;6,2;13
31;"Itatiaia";2020;294;69;30;99;23,5;10,2;33,7
32;"Japeri";2020;715;48;91;139;6,7;12,7;19,4
33;"Laje do Muriaé";2020;128;24;28;52;18,8;21,9;40,6
34;"Macaé";2020;1298;201;105;306;15,5;8,1;23,6
35;"Magé";2020;1550;92;368;460;5,9;23,7;29,7
36;"Mangaratiba";2020;404;31;40;71;7,7;9,9;17,6
37;"Maricá";2020;2340;55;149;204;2,4;6,4;8,7
38;"Mendes";2020;315;42;49;91;13,3;15,6;28,9
40;"Miguel Pereira";2020;317;35;41;76;11;12,9;24
41;"Miracema";2020;475;45;95;140;9,5;20;29,5
42;"Natividade";2020;202;22;38;60;10,9;18,8;29,7
43;"Nilópolis";2020;39;0;3;3;0;7,7;7,7
44;"Niterói";2020;3857;609;310;919;15,8;8;23,8
45;"Nova Friburgo";2020;1704;113;267;380;6,6;15,7;22,3
46;"Nova Iguaçu";2020;7109;1058;1141;2199;14,9;16,1;30,9
47;"Paracambi";2020;442;59;33;92;13,3;7,5;20,8
48;"Paraíba do Sul";2020;286;50;23;73;17,5;8;25,5
49;"Paraty";2020;454;30;21;51;6,6;4,6;11,2
50;"Paty do Alferes";2020;225;44;32;76;19,6;14,2;33,8
51;"Petrópolis";2020;2433;756;401;1157;31,1;16,5;47,6
52;"Pinheiral";2020;348;19;68;87;5,5;19,5;25
53;"Piraí";2020;261;53;49;102;20,3;18,8;39,1
54;"Porciúncula";2020;603;72;90;162;11,9;14,9;26,9
55;"Porto Real-Quatis";2020;123;23;12;35;18,7;9,8;28,5
56;"Queimados";2020;836;117;55;172;14;6,6;20,6
57;"Resende";2020;1600;139;75;214;8,7;4,7;13,4
58;"Rio Bonito";2020;302;63;9;72;20,9;3;23,8
59;"Rio Claro";2020;213;4;32;36;1,9;15;16,9
60;"Rio Das Flores";2020;67;17;6;23;25,4;9;34,3
61;"Rio Das Ostras";2020;1441;142;178;320;9,9;12,4;22,2
62;"Santa Maria Madalena";2020;75;0;14;14;0;18,7;18,7
63;"Santo Antônio de Pádua";2020;861;85;77;162;9,9;8,9;18,8
64;"São Fidélis";2020;288;47;19;66;16,3;6,6;22,9
65;"São Francisco do Itabapoana";2020;515;16;22;38;3,1;4,3;7,4
66;"São Gonçalo";2020;3950;687;528;1215;17,4;13,4;30,8
67;"São João da Barra";2020;463;151;40;191;32,6;8,6;41,3
68;"São João de Meriti";2020;188;5;19;24;2,7;10,1;12,8
69;"São José do Vale do Rio Preto";2020;214;8;15;23;3,7;7;10,7
70;"São Pedro da Aldeia";2020;675;119;111;230;17,6;16,4;34,1
71;"São Sebastião do Alto";2020;209;8;32;40;3,8;15,3;19,1
72;"Sapucaia";2020;306;43;56;99;14,1;18,3;32,4
73;"Saquarema";2020;114;25;21;46;21,9;18,4;40,4
74;"Seropédica";2020;716;107;57;164;14,9;8;22,9
75;"Silva Jardim";2020;347;62;78;140;17,9;22,5;40,3
76;"Sumidouro";2020;166;30;31;61;18,1;18,7;36,7
78;"Teresópolis";2020;1255;167;98;265;13,3;7,8;21,1
79;"Trajano de Moraes";2020;183;6;47;53;3,3;25,7;29
80;"Três Rios";2020;1344;284;156;440;21,1;11,6;32,7
81;"Valença";2020;847;55;131;186;6,5;15,5;22
82;"Vassouras";2020;652;36;83;119;5,5;12,7;18,3
83;"Volta Redonda";2020;2319;212;203;415;9,1;8,8;17,9
1;"Angra dos Reis";2019;2289;152;248;400;6,6;10,8;17,5
2;"Araruama";2019;1989;481;205;686;24,2;10,3;34,5
3;"Armação dos Búzios";2019;553;103;70;173;18,6;12,7;31,3
4;"Arraial do Cabo";2019;543;56;69;125;10,3;12,7;23
5;"Barra do Piraí";2019;2154;186;552;738;8,6;25,6;34,3
6;"Barra Mansa";2019;1942;365;282;647;18,8;14,5;33,3
7;"Belford Roxo";2019;5850;0;21;21;0;0,4;0,4
8;"Bom Jardim";2019;237;44;25;69;18,6;10,5;29,1
9;"Bom Jesus do Itabapoana";2019;478;76;117;193;15,9;24,5;40,4
10;"Cabo Frio";2019;4247;414;490;904;9,7;11,5;21,3
11;"Cachoeiras de Macacu";2019;485;77;58;135;15,9;12;27,8
12;"Cambuci";2019;307;22;35;57;7,2;11,4;18,6
13;"Campos dos Goytacazes";2019;3627;793;128;921;21,9;3,5;25,4
14;"Cantagalo";2019;269;48;78;126;17,8;29;46,8
15;"Rio de Janeiro";2019;54455;12359;6526;18885;22,7;12;34,7
16;"Carapebus/Quissamã";2019;586;85;84;169;14,5;14,3;28,8
17;"Carmo";2019;744;114;182;296;15,3;24,5;39,8
18;"Casimiro de Abreu";2019;706;73;78;151;10,3;11;21,4
19;"Conceição de Macabu";2019;320;33;41;74;10,3;12,8;23,1
20;"Cordeiro";2019;393;83;69;152;21,1;17,6;38,7
21;"Duas Barras";2019;262;20;47;67;7,6;17,9;25,6
22;"Duque de Caxias";2019;11764;2527;2994;5521;21,5;25,5;46,9
23;"Engenheiro Paulo de Frontin";2019;245;22;57;79;9;23,3;32,2
24;"Guapimirim";2019;636;112;71;183;17,6;11,2;28,8
25;"Iguaba Grande";2019;294;78;40;118;26,5;13,6;40,1
26;"Itaboraí";2019;2836;212;213;425;7,5;7,5;15
27;"Itaguaí";2019;1672;461;588;1049;27,6;35,2;62,7
28;"Italva(Cardoso Moreira)";2019;548;73;133;206;13,3;24,3;37,6
29;"Itaocara";2019;511;109;134;243;21,3;26,2;47,6
30;"Itaperuna";2019;2908;164;358;522;5,6;12,3;18
31;"Itatiaia";2019;247;54;58;112;21,9;23,5;45,3
32;"Japeri";2019;1729;215;240;455;12,4;13,9;26,3
33;"Laje do Muriaé";2019;166;31;39;70;18,7;23,5;42,2
34;"Macaé";2019;3661;320;243;563;8,7;6,6;15,4
35;"Magé";2019;2465;415;780;1195;16,8;31,6;48,5
36;"Mangaratiba";2019;806;51;77;128;6,3;9,6;15,9
37;"Maricá";2019;1113;54;86;140;4,9;7,7;12,6
38;"Mendes";2019;298;53;55;108;17,8;18,5;36,2
40;"Miguel Pereira";2019;331;69;72;141;20,8;21,8;42,6
41;"Miracema";2019;699;115;193;308;16,5;27,6;44,1
42;"Natividade";2019;233;34;44;78;14,6;18,9;33,5
43;"Nilópolis";2019;516;0;31;31;0;6;6
44;"Niterói";2019;5056;895;774;1669;17,7;15,3;33
45;"Nova Friburgo";2019;2216;303;526;829;13,7;23,7;37,4
46;"Nova Iguaçu";2019;11325;1899;4108;6007;16,8;36,3;53
47;"Paracambi";2019;602;69;100;169;11,5;16,6;28,1
48;"Paraíba do Sul";2019;455;146;43;189;32,1;9,5;41,5
49;"Paraty";2019;575;83;62;145;14,4;10,8;25,2
50;"Paty do Alferes";2019;346;77;66;143;22,3;19,1;41,3
51;"Petrópolis";2019;2801;1081;606;1687;38,6;21,6;60,2
52;"Pinheiral";2019;443;27;111;138;6,1;25,1;31,2
53;"Piraí";2019;296;72;94;166;24,3;31,8;56,1
54;"Porciúncula";2019;718;81;111;192;11,3;15,5;26,7
55;"Porto Real-Quatis";2019;183;39;27;66;21,3;14,8;36,1
56;"Queimados";2019;1089;254;97;351;23,3;8,9;32,2
57;"Resende";2019;3127;421;388;809;13,5;12,4;25,9
58;"Rio Bonito";2019;690;128;35;163;18,6;5,1;23,6
59;"Rio Claro";2019;827;45;256;301;5,4;31;36,4
60;"Rio Das Flores";2019;101;25;16;41;24,8;15,8;40,6
61;"Rio Das Ostras";2019;2627;196;349;545;7,5;13,3;20,7
62;"Santa Maria Madalena";2019;154;10;34;44;6,5;22,1;28,6
63;"Santo Antônio de Pádua";2019;951;99;155;254;10,4;16,3;26,7
64;"São Fidélis";2019;424;115;79;194;27,1;18,6;45,8
65;"São Francisco do Itabapoana";2019;792;58;59;117;7,3;7,4;14,8
66;"São Gonçalo";2019;4991;1182;749;1931;23,7;15;38,7
67;"São João da Barra";2019;501;166;35;201;33,1;7;40,1
68;"São João de Meriti";2019;188;5;10;15;2,7;5,3;8
69;"São José do Vale do Rio Preto";2019;221;17;31;48;7,7;14;21,7
70;"São Pedro da Aldeia";2019;1034;195;225;420;18,9;21,8;40,6
71;"São Sebastião do Alto";2019;714;9;78;87;1,3;10,9;12,2
72;"Sapucaia";2019;353;52;100;152;14,7;28,3;43,1
73;"Saquarema";2019;81;27;15;42;33,3;18,5;51,9
74;"Seropédica";2019;1254;194;124;318;15,5;9,9;25,4
75;"Silva Jardim";2019;198;69;48;117;34,8;24,2;59,1
76;"Sumidouro";2019;195;68;37;105;34,9;19;53,8
78;"Teresópolis";2019;2032;414;345;759;20,4;17;37,4
79;"Trajano de Moraes";2019;169;25;70;95;14,8;41,4;56,2
80;"Três Rios";2019;1698;517;269;786;30,4;15,8;46,3
81;"Valença";2019;1516;120;630;750;7,9;41,6;49,5
82;"Vassouras";2019;1064;79;152;231;7,4;14,3;21,7
83;"Volta Redonda";2019;2760;244;201;445;8,8;7,3;16,1
1;"Angra dos Reis";2018;1400;175;245;420;12,5;17,5;30
2;"Araruama";2018;2652;506;465;971;19,1;17,5;36,6
3;"Armação dos Búzios";2018;547;103;72;175;18,8;13,2;32
4;"Arraial do Cabo";2018;495;83;108;191;16,8;21,8;38,6
5;"Barra do Piraí";2018;1666;292;470;762;17,5;28,2;45,7
6;"Barra Mansa";2018;1709;347;341;688;20,3;20;40,3
7;"Belford Roxo";2018;2284;2;8;10;0,1;0,4;0,4
8;"Bom Jardim";2018;228;39;38;77;17,1;16,7;33,8
9;"Bom Jesus do Itabapoana";2018;422;106;102;208;25,1;24,2;49,3
10;"Cabo Frio";2018;4202;412;879;1291;9,8;20,9;30,7
11;"Cachoeiras de Macacu";2018;449;61;72;133;13,6;16;29,6
12;"Cambuci";2018;187;17;20;37;9,1;10,7;19,8
13;"Campos dos Goytacazes";2018;2456;453;91;544;18,4;3,7;22,1
14;"Cantagalo";2018;248;69;74;143;27,8;29,8;57,7
15;"Rio de Janeiro";2018;52971;13378;8524;21902;25,3;16,1;41,3
16;"Carapebus/Quissamã";2018;640;98;90;188;15,3;14,1;29,4
17;"Carmo";2018;770;91;245;336;11,8;31,8;43,6
18;"Casimiro de Abreu";2018;721;79;96;175;11;13,3;24,3
19;"Conceição de Macabu";2018;353;38;97;135;10,8;27,5;38,2
20;"Cordeiro";2018;497;114;120;234;22,9;24,1;47,1
21;"Duas Barras";2018;312;51;81;132;16,3;26;42,3
22;"Duque de Caxias";2018;12047;3216;4444;7660;26,7;36,9;63,6
23;"Engenheiro Paulo de Frontin";2018;231;30;70;100;13;30,3;43,3
24;"Guapimirim";2018;748;191;127;318;25,5;17;42,5
25;"Iguaba Grande";2018;182;43;34;77;23,6;18,7;42,3
26;"Itaboraí";2018;2040;248;306;554;12,2;15;27,2
27;"Itaguaí";2018;2769;385;1864;2249;13,9;67,3;81,2
28;"Italva(Cardoso Moreira)";2018;450;69;144;213;15,3;32;47,3
29;"Itaocara";2018;432;96;130;226;22,2;30,1;52,3
30;"Itaperuna";2018;2348;136;551;687;5,8;23,5;29,3
31;"Itatiaia";2018;379;78;87;165;20,6;23;43,5
32;"Japeri";2018;1190;164;232;396;13,8;19,5;33,3
33;"Laje do Muriaé";2018;120;19;32;51;15,8;26,7;42,5
34;"Macaé";2018;3082;393;554;947;12,8;18;30,7
35;"Magé";2018;2130;341;714;1055;16;33,5;49,5
36;"Mangaratiba";2018;673;62;107;169;9,2;15,9;25,1
37;"Maricá";2018;1677;72;223;295;4,3;13,3;17,6
38;"Mendes";2018;210;45;44;89;21,4;21;42,4
40;"Miguel Pereira";2018;259;71;49;120;27,4;18,9;46,3
41;"Miracema";2018;410;82;105;187;20;25,6;45,6
42;"Natividade";2018;326;66;92;158;20,2;28,2;48,5
43;"Nilópolis";2018;497;2;23;25;0,4;4,6;5
44;"Niterói";2018;4814;1089;859;1948;22,6;17,8;40,5
45;"Nova Friburgo";2018;2045;309;560;869;15,1;27,4;42,5
46;"Nova Iguaçu";2018;12059;1773;5165;6938;14,7;42,8;57,5
47;"Paracambi";2018;647;118;85;203;18,2;13,1;31,4
48;"Paraíba do Sul";2018;437;166;70;236;38;16;54
49;"Paraty";2018;357;89;60;149;24,9;16,8;41,7
50;"Paty do Alferes";2018;226;64;40;104;28,3;17,7;46
51;"Petrópolis";2018;2911;1145;863;2008;39,3;29,6;69
52;"Pinheiral";2018;475;32;128;160;6,7;26,9;33,7
53;"Piraí";2018;316;85;61;146;26,9;19,3;46,2
54;"Porciúncula";2018;468;66;98;164;14,1;20,9;35
55;"Porto Real-Quatis";2018;207;42;40;82;20,3;19,3;39,6
56;"Queimados";2018;1371;230;222;452;16,8;16,2;33
57;"Resende";2018;1336;285;352;637;21,3;26,3;47,7
58;"Rio Bonito";2018;455;93;52;145;20,4;11,4;31,9
59;"Rio Claro";2018;259;47;48;95;18,1;18,5;36,7
60;"Rio Das Flores";2018;141;28;39;67;19,9;27,7;47,5
61;"Rio Das Ostras";2018;3426;348;534;882;10,2;15,6;25,7
62;"Santa Maria Madalena";2018;167;21;52;73;12,6;31,1;43,7
63;"Santo Antônio de Pádua";2018;914;144;191;335;15,8;20,9;36,7
64;"São Fidélis";2018;317;87;69;156;27,4;21,8;49,2
65;"São Francisco do Itabapoana";2018;514;45;44;89;8,8;8,6;17,3
66;"São Gonçalo";2018;6196;1462;1320;2782;23,6;21,3;44,9
67;"São João da Barra";2018;439;128;29;157;29,2;6,6;35,8
68;"São João de Meriti";2018;68;2;7;9;2,9;10,3;13,2
69;"São José do Vale do Rio Preto";2018;281;26;34;60;9,3;12,1;21,4
70;"São Pedro da Aldeia";2018;793;149;195;344;18,8;24,6;43,4
71;"São Sebastião do Alto";2018;1003;18;740;758;1,8;73,8;75,6
72;"Sapucaia";2018;239;50;50;100;20,9;20,9;41,8
73;"Saquarema";2018;246;72;35;107;29,3;14,2;43,5
74;"Seropédica";2018;690;129;85;214;18,7;12,3;31
75;"Silva Jardim";2018;116;28;22;50;24,1;19;43,1
76;"Sumidouro";2018;133;51;32;83;38,3;24,1;62,4
78;"Teresópolis";2018;2064;449;494;943;21,8;23,9;45,7
79;"Trajano de Moraes";2018;124;18;52;70;14,5;41,9;56,5
80;"Três Rios";2018;1717;611;282;893;35,6;16,4;52
81;"Valença";2018;1297;200;378;578;15,4;29,1;44,6
82;"Vassouras";2018;901;49;172;221;5,4;19,1;24,5
83;"Volta Redonda";2018;3590;357;388;745;9,9;10,8;20,8
1;"Angra dos Reis";2017;2061;210;362;572;10,2;17,6;27,8
2;"Araruama";2017;2797;378;603;981;13,5;21,6;35,1
3;"Armação dos Búzios";2017;586;110;131;241;18,8;22,4;41,1
4;"Arraial do Cabo";2017;556;67;197;264;12,1;35,4;47,5
5;"Barra do Piraí";2017;1221;218;347;565;17,9;28,4;46,3
6;"Barra Mansa";2017;1801;296;318;614;16,4;17,7;34,1
7;"Belford Roxo";2017;2460;1;17;18;0;0,7;0,7
8;"Bom Jardim";2017;250;48;50;98;19,2;20;39,2
9;"Bom Jesus do Itabapoana";2017;533;97;116;213;18,2;21,8;40
10;"Cabo Frio";2017;3211;258;949;1207;8;29,6;37,6
11;"Cachoeiras de Macacu";2017;717;99;157;256;13,8;21,9;35,7
12;"Cambuci";2017;199;14;61;75;7;30,7;37,7
13;"Campos dos Goytacazes";2017;2709;304;200;504;11,2;7,4;18,6
14;"Cantagalo";2017;301;62;121;183;20,6;40,2;60,8
15;"Rio de Janeiro";2017;51540;10734;12064;22798;20,8;23,4;44,2
16;"Carapebus/Quissamã";2017;571;71;109;180;12,4;19,1;31,5
17;"Carmo";2017;563;65;78;143;11,5;13,9;25,4
18;"Casimiro de Abreu";2017;501;52;74;126;10,4;14,8;25,1
19;"Conceição de Macabu";2017;247;28;64;92;11,3;25,9;37,2
20;"Cordeiro";2017;358;86;91;177;24;25,4;49,4
21;"Duas Barras";2017;218;19;61;80;8,7;28;36,7
22;"Duque de Caxias";2017;11822;2373;6905;9278;20,1;58,4;78,5
23;"Engenheiro Paulo de Frontin";2017;256;18;90;108;7;35,2;42,2
24;"Guapimirim";2017;824;188;213;401;22,8;25,8;48,7
25;"Iguaba Grande";2017;279;68;54;122;24,4;19,4;43,7
26;"Itaboraí";2017;2125;165;552;717;7,8;26;33,7
27;"Itaguaí";2017;2442;276;1060;1336;11,3;43,4;54,7
28;"Italva(Cardoso Moreira)";2017;369;73;114;187;19,8;30,9;50,7
29;"Itaocara";2017;365;97;120;217;26,6;32,9;59,5
30;"Itaperuna";2017;2696;235;887;1122;8,7;32,9;41,6
31;"Itatiaia";2017;245;65;60;125;26,5;24,5;51
32;"Japeri";2017;1402;141;412;553;10,1;29,4;39,4
33;"Laje do Muriaé";2017;147;31;49;80;21,1;33,3;54,4
34;"Macaé";2017;2639;322;737;1059;12,2;27,9;40,1
35;"Magé";2017;2096;350;739;1089;16,7;35,3;52
36;"Mangaratiba";2017;927;48;151;199;5,2;16,3;21,5
37;"Maricá";2017;2749;131;563;694;4,8;20,5;25,2
38;"Mendes";2017;287;42;86;128;14,6;30;44,6
40;"Miguel Pereira";2017;321;90;67;157;28;20,9;48,9
41;"Miracema";2017;271;54;75;129;19,9;27,7;47,6
42;"Natividade";2017;346;71;120;191;20,5;34,7;55,2
43;"Nilópolis";2017;571;3;53;56;0,5;9,3;9,8
44;"Niterói";2017;4783;776;1065;1841;16,2;22,3;38,5
45;"Nova Friburgo";2017;3420;330;869;1199;9,6;25,4;35,1
46;"Nova Iguaçu";2017;10724;1335;5550;6885;12,4;51,8;64,2
47;"Paracambi";2017;596;128;117;245;21,5;19,6;41,1
48;"Paraíba do Sul";2017;394;122;61;183;31;15,5;46,4
49;"Paraty";2017;268;70;57;127;26,1;21,3;47,4
50;"Paty do Alferes";2017;199;44;24;68;22,1;12,1;34,2
51;"Petrópolis";2017;2403;908;738;1646;37,8;30,7;68,5
52;"Pinheiral";2017;275;21;97;118;7,6;35,3;42,9
53;"Piraí";2017;271;73;71;144;26,9;26,2;53,1
54;"Porciúncula";2017;429;71;117;188;16,6;27,3;43,8
55;"Porto Real-Quatis";2017;222;38;57;95;17,1;25,7;42,8
56;"Queimados";2017;840;136;224;360;16,2;26,7;42,9
57;"Resende";2017;1782;409;364;773;23;20,4;43,4
58;"Rio Bonito";2017;459;74;59;133;16,1;12,9;29
59;"Rio Claro";2017;371;38;74;112;10,2;19,9;30,2
60;"Rio Das Flores";2017;119;28;42;70;23,5;35,3;58,8
61;"Rio Das Ostras";2017;1968;250;621;871;12,7;31,6;44,3
62;"Santa Maria Madalena";2017;107;22;36;58;20,6;33,6;54,2
63;"Santo Antônio de Pádua";2017;661;57;132;189;8,6;20;28,6
64;"São Fidélis";2017;338;65;101;166;19,2;29,9;49,1
65;"São Francisco do Itabapoana";2017;466;81;82;163;17,4;17,6;35
66;"São Gonçalo";2017;4558;853;1367;2220;18,7;30;48,7
67;"São João da Barra";2017;490;73;45;118;14,9;9,2;24,1
68;"São João de Meriti";2017;328;2;6;8;0,6;1,8;2,4
69;"São José do Vale do Rio Preto";2017;200;24;27;51;12;13,5;25,5
70;"São Pedro da Aldeia";2017;640;111;236;347;17,3;36,9;54,2
71;"São Sebastião do Alto";2017;116;25;42;67;21,6;36,2;57,8
72;"Sapucaia";2017;288;57;47;104;19,8;16,3;36,1
73;"Saquarema";2017;155;27;54;81;17,4;34,8;52,3
74;"Seropédica";2017;795;118;184;302;14,8;23,1;38
75;"Silva Jardim";2017;138;38;35;73;27,5;25,4;52,9
76;"Sumidouro";2017;117;38;32;70;32,5;27,4;59,8
78;"Teresópolis";2017;1906;440;442;882;23,1;23,2;46,3
79;"Trajano de Moraes";2017;147;26;72;98;17,7;49;66,7
80;"Três Rios";2017;1629;475;361;836;29,2;22,2;51,3
81;"Valença";2017;1103;146;409;555;13,2;37,1;50,3
82;"Vassouras";2017;970;80;257;337;8,2;26,5;34,7
83;"Volta Redonda";2017;3009;299;331;630;9,9;11;20,9
1;"Angra dos Reis";2016;1495;367;457;824;24,5;30,6;55,1
2;"Araruama";2016;3028;321;929;1250;10,6;30,7;41,3
3;"Armação dos Búzios";2016;704;209;117;326;29,7;16,6;46,3
4;"Arraial do Cabo";2016;475;70;85;155;14,7;17,9;32,6
5;"Barra do Piraí";2016;1229;155;431;586;12,6;35,1;47,7
6;"Barra Mansa";2016;1338;232;389;621;17,3;29,1;46,4
7;"Belford Roxo";2016;2050;5;17;22;0,2;0,8;1,1
8;"Bom Jardim";2016;249;49;72;121;19,7;28,9;48,6
9;"Bom Jesus do Itabapoana";2016;409;67;123;190;16,4;30,1;46,5
10;"Cabo Frio";2016;5212;451;2237;2688;8,7;42,9;51,6
11;"Cachoeiras de Macacu";2016;709;92;201;293;13;28,3;41,3
12;"Cambuci";2016;174;19;52;71;10,9;29,9;40,8
13;"Campos dos Goytacazes";2016;2329;243;202;445;10,4;8,7;19,1
14;"Cantagalo";2016;224;54;65;119;24,1;29;53,1
15;"Rio de Janeiro";2016;57088;10691;17438;28129;18,7;30,5;49,3
16;"Carapebus/Quissamã";2016;716;90;186;276;12,6;26;38,5
17;"Carmo";2016;385;60;75;135;15,6;19,5;35,1
18;"Casimiro de Abreu";2016;393;45;78;123;11,5;19,8;31,3
19;"Conceição de Macabu";2016;238;21;63;84;8,8;26,5;35,3
20;"Cordeiro";2016;359;77;84;161;21,4;23,4;44,8
21;"Duas Barras";2016;256;18;56;74;7;21,9;28,9
22;"Duque de Caxias";2016;15643;2823;9379;12202;18;60;78
23;"Engenheiro Paulo de Frontin";2016;187;39;46;85;20,9;24,6;45,5
24;"Guapimirim";2016;1219;158;263;421;13;21,6;34,5
25;"Iguaba Grande";2016;450;93;62;155;20,7;13,8;34,4
26;"Itaboraí";2016;3160;238;1004;1242;7,5;31,8;39,3
27;"Itaguaí";2016;1521;387;362;749;25,4;23,8;49,2
28;"Italva(Cardoso Moreira)";2016;383;66;115;181;17,2;30;47,3
29;"Itaocara";2016;246;60;84;144;24,4;34,1;58,5
30;"Itaperuna";2016;1461;202;590;792;13,8;40,4;54,2
31;"Itatiaia";2016;300;67;63;130;22,3;21;43,3
32;"Japeri";2016;474;47;137;184;9,9;28,9;38,8
33;"Laje do Muriaé";2016;97;20;27;47;20,6;27,8;48,5
34;"Macaé";2016;2554;243;537;780;9,5;21;30,5
35;"Magé";2016;2447;312;486;798;12,8;19,9;32,6
36;"Mangaratiba";2016;726;60;81;141;8,3;11,2;19,4
37;"Maricá";2016;1821;151;428;579;8,3;23,5;31,8
38;"Mendes";2016;362;44;154;198;12,2;42,5;54,7
40;"Miguel Pereira";2016;375;91;83;174;24,3;22,1;46,4
41;"Miracema";2016;305;88;69;157;28,9;22,6;51,5
42;"Natividade";2016;324;87;112;199;26,9;34,6;61,4
43;"Nilópolis";2016;983;1;36;37;0,1;3,7;3,8
44;"Niterói";2016;6654;753;1463;2216;11,3;22;33,3
45;"Nova Friburgo";2016;2446;292;863;1155;11,9;35,3;47,2
46;"Nova Iguaçu";2016;12107;1666;7779;9445;13,8;64,3;78
47;"Paracambi";2016;716;130;198;328;18,2;27,7;45,8
48;"Paraíba do Sul";2016;301;100;42;142;33,2;14;47,2
49;"Paraty";2016;292;52;73;125;17,8;25;42,8
50;"Paty do Alferes";2016;202;54;52;106;26,7;25,7;52,5
51;"Petrópolis";2016;2698;842;779;1621;31,2;28,9;60,1
52;"Pinheiral";2016;440;23;124;147;5,2;28,2;33,4
53;"Piraí";2016;330;109;79;188;33;23,9;57
54;"Porciúncula";2016;413;93;107;200;22,5;25,9;48,4
55;"Porto Real-Quatis";2016;245;49;54;103;20;22;42
56;"Queimados";2016;1977;109;287;396;5,5;14,5;20
57;"Resende";2016;1946;393;570;963;20,2;29,3;49,5
58;"Rio Bonito";2016;590;87;98;185;14,7;16,6;31,4
59;"Rio Claro";2016;307;34;32;66;11,1;10,4;21,5
60;"Rio Das Flores";2016;100;22;31;53;22;31;53
61;"Rio Das Ostras";2016;2041;292;725;1017;14,3;35,5;49,8
62;"Santa Maria Madalena";2016;98;19;41;60;19,4;41,8;61,2
63;"Santo Antônio de Pádua";2016;610;75;148;223;12,3;24,3;36,6
64;"São Fidélis";2016;420;79;97;176;18,8;23,1;41,9
65;"São Francisco do Itabapoana";2016;556;52;98;150;9,4;17,6;27
66;"São Gonçalo";2016;7320;1390;2630;4020;19;35,9;54,9
67;"São João da Barra";2016;604;116;128;244;19,2;21,2;40,4
68;"São João de Meriti";2016;2683;6;55;61;0,2;2;2,3
69;"São José do Vale do Rio Preto";2016;136;15;26;41;11;19,1;30,1
70;"São Pedro da Aldeia";2016;706;84;281;365;11,9;39,8;51,7
71;"São Sebastião do Alto";2016;23;2;5;7;8,7;21,7;30,4
72;"Sapucaia";2016;259;43;43;86;16,6;16,6;33,2
73;"Saquarema";2016;126;22;79;101;17,5;62,7;80,2
74;"Seropédica";2016;648;81;148;229;12,5;22,8;35,3
75;"Silva Jardim";2016;132;47;31;78;35,6;23,5;59,1
76;"Sumidouro";2016;137;40;42;82;29,2;30,7;59,9
78;"Teresópolis";2016;3136;707;857;1564;22,5;27,3;49,9
79;"Trajano de Moraes";2016;213;20;99;119;9,4;46,5;55,9
80;"Três Rios";2016;1390;454;281;735;32,7;20,2;52,9
81;"Valença";2016;879;160;208;368;18,2;23,7;41,9
82;"Vassouras";2016;1081;109;381;490;10,1;35,2;45,3
83;"Volta Redonda";2016;2040;339;465;804;16,6;22,8;39,4
1;"Angra dos Reis";2015;2843;335;984;1319;11,8;34,6;46,4
2;"Araruama";2015;3990;247;1604;1851;6,2;40,2;46,4
3;"Armação dos Búzios";2015;951;149;198;347;15,7;20,8;36,5
4;"Arraial do Cabo";2015;544;64;151;215;11,8;27,8;39,5
5;"Barra do Piraí";2015;1185;160;383;543;13,5;32,3;45,8
6;"Barra Mansa";2015;1730;285;489;774;16,5;28,3;44,7
7;"Belford Roxo";2015;1762;9;26;35;0,5;1,5;2
8;"Bom Jardim";2015;205;42;72;114;20,5;35,1;55,6
9;"Bom Jesus do Itabapoana";2015;561;130;209;339;23,2;37,3;60,4
10;"Cabo Frio";2015;3312;471;1241;1712;14,2;37,5;51,7
11;"Cachoeiras de Macacu";2015;597;78;115;193;13,1;19,3;32,3
12;"Cambuci";2015;232;33;67;100;14,2;28,9;43,1
13;"Campos dos Goytacazes";2015;3907;622;402;1024;15,9;10,3;26,2
14;"Cantagalo";2015;190;48;45;93;25,3;23,7;48,9
15;"Rio de Janeiro";2015;63565;11729;20097;31826;18,5;31,6;50,1
16;"Carapebus/Quissamã";2015;946;98;271;369;10,4;28,6;39
17;"Carmo";2015;220;52;51;103;23,6;23,2;46,8
18;"Casimiro de Abreu";2015;568;98;149;247;17,3;26,2;43,5
19;"Conceição de Macabu";2015;318;27;129;156;8,5;40,6;49,1
20;"Cordeiro";2015;381;96;136;232;25,2;35,7;60,9
21;"Duas Barras";2015;336;33;86;119;9,8;25,6;35,4
22;"Duque de Caxias";2015;11476;2526;6836;9362;22;59,6;81,6
23;"Engenheiro Paulo de Frontin";2015;260;38;99;137;14,6;38,1;52,7
24;"Guapimirim";2015;786;63;187;250;8;23,8;31,8
25;"Iguaba Grande";2015;349;83;69;152;23,8;19,8;43,6
26;"Itaboraí";2015;2578;243;907;1150;9,4;35,2;44,6
27;"Itaguaí";2015;1543;292;368;660;18,9;23,8;42,8
28;"Italva(Cardoso Moreira)";2015;370;89;112;201;24,1;30,3;54,3
29;"Itaocara";2015;316;79;104;183;25;32,9;57,9
30;"Itaperuna";2015;1023;192;277;469;18,8;27,1;45,8
31;"Itatiaia";2015;348;78;85;163;22,4;24,4;46,8
32;"Japeri";2015;658;53;274;327;8,1;41,6;49,7
33;"Laje do Muriaé";2015;92;21;19;40;22,8;20,7;43,5
34;"Macaé";2015;2054;248;577;825;12,1;28,1;40,2
35;"Magé";2015;2952;313;532;845;10,6;18;28,6
36;"Mangaratiba";2015;863;138;152;290;16;17,6;33,6
37;"Maricá";2015;2608;219;694;913;8,4;26,6;35
38;"Mendes";2015;209;48;51;99;23;24,4;47,4
40;"Miguel Pereira";2015;299;98;72;170;32,8;24,1;56,9
41;"Miracema";2015;378;80;91;171;21,2;24,1;45,2
42;"Natividade";2015;278;100;73;173;36;26,3;62,2
43;"Nilópolis";2015;185;13;20;33;7;10,8;17,8
44;"Niterói";2015;5789;834;1843;2677;14,4;31,8;46,2
45;"Nova Friburgo";2015;3031;360;924;1284;11,9;30,5;42,4
46;"Nova Iguaçu";2015;13242;1644;7083;8727;12,4;53,5;65,9
47;"Paracambi";2015;725;161;175;336;22,2;24,1;46,3
48;"Paraíba do Sul";2015;378;135;72;207;35,7;19;54,8
49;"Paraty";2015;328;41;130;171;12,5;39,6;52,1
50;"Paty do Alferes";2015;221;62;37;99;28,1;16,7;44,8
51;"Petrópolis";2015;2882;947;777;1724;32,9;27;59,8
52;"Pinheiral";2015;460;60;154;214;13;33,5;46,5
53;"Piraí";2015;476;127;123;250;26,7;25,8;52,5
54;"Porciúncula";2015;439;105;106;211;23,9;24,1;48,1
55;"Porto Real-Quatis";2015;269;49;76;125;18,2;28,3;46,5
56;"Queimados";2015;1132;170;231;401;15;20,4;35,4
57;"Resende";2015;2242;316;630;946;14,1;28,1;42,2
58;"Rio Bonito";2015;625;123;129;252;19,7;20,6;40,3
59;"Rio Claro";2015;315;43;34;77;13,7;10,8;24,4
60;"Rio Das Flores";2015;122;20;48;68;16,4;39,3;55,7
61;"Rio Das Ostras";2015;2173;408;854;1262;18,8;39,3;58,1
62;"Santa Maria Madalena";2015;137;38;42;80;27,7;30,7;58,4
63;"Santo Antônio de Pádua";2015;767;85;248;333;11,1;32,3;43,4
64;"São Fidélis";2015;596;111;156;267;18,6;26,2;44,8
65;"São Francisco do Itabapoana";2015;729;71;158;229;9,7;21,7;31,4
66;"São Gonçalo";2015;7276;1114;2736;3850;15,3;37,6;52,9
67;"São João da Barra";2015;645;130;121;251;20,2;18,8;38,9
68;"São João de Meriti";2015;2317;4;42;46;0,2;1,8;2
69;"São José do Vale do Rio Preto";2015;238;30;56;86;12,6;23,5;36,1
70;"São Pedro da Aldeia";2015;1018;113;439;552;11,1;43,1;54,2
71;"São Sebastião do Alto";2015;72;9;25;34;12,5;34,7;47,2
72;"Sapucaia";2015;192;27;48;75;14,1;25;39,1
73;"Saquarema";2015;90;0;70;70;0;77,8;77,8
74;"Seropédica";2015;736;83;267;350;11,3;36,3;47,6
75;"Silva Jardim";2015;181;43;67;110;23,8;37;60,8
76;"Sumidouro";2015;119;31;44;75;26,1;37;63
78;"Teresópolis";2015;2926;511;680;1191;17,5;23,2;40,7
79;"Trajano de Moraes";2015;227;36;92;128;15,9;40,5;56,4
80;"Três Rios";2015;1562;499;361;860;31,9;23,1;55,1
81;"Valença";2015;1014;198;283;481;19,5;27,9;47,4
82;"Vassouras";2015;727;94;165;259;12,9;22,7;35,6
83;"Volta Redonda";2015;1570;345;388;733;22;24,7;46,7
1;"Angra dos Reis";2014;2250;259;996;1255;11,5;44,3;55,8
2;"Araruama";2014;3488;223;1298;1521;6,4;37,2;43,6
3;"Armação dos Búzios";2014;1011;131;499;630;13;49,4;62,3
4;"Arraial do Cabo";2014;641;77;200;277;12;31,2;43,2
5;"Barra do Piraí";2014;965;197;398;595;20,4;41,2;61,7
6;"Barra Mansa";2014;1562;292;501;793;18,7;32,1;50,8
7;"Belford Roxo";2014;683;4;27;31;0,6;4;4,5
8;"Bom Jardim";2014;546;83;132;215;15,2;24,2;39,4
9;"Bom Jesus do Itabapoana";2014;479;102;114;216;21,3;23,8;45,1
10;"Cabo Frio";2014;3605;558;1176;1734;15,5;32,6;48,1
11;"Cachoeiras de Macacu";2014;731;117;185;302;16;25,3;41,3
12;"Cambuci";2014;195;28;71;99;14,4;36,4;50,8
13;"Campos dos Goytacazes";2014;5563;1066;860;1926;19,2;15,5;34,6
14;"Cantagalo";2014;406;76;121;197;18,7;29,8;48,5
15;"Rio de Janeiro";2014;80664;14062;27980;42042;17,4;34,7;52,1
16;"Carapebus/Quissamã";2014;468;55;152;207;11,8;32,5;44,2
17;"Carmo";2014;353;67;67;134;19;19;38
18;"Casimiro de Abreu";2014;854;87;297;384;10,2;34,8;45
19;"Conceição de Macabu";2014;251;28;90;118;11,2;35,9;47
20;"Cordeiro";2014;379;91;111;202;24;29,3;53,3
21;"Duas Barras";2014;361;11;123;134;3;34,1;37,1
22;"Duque de Caxias";2014;16862;3271;10808;14079;19,4;64,1;83,5
23;"Engenheiro Paulo de Frontin";2014;235;36;61;97;15,3;26;41,3
24;"Guapimirim";2014;1014;84;201;285;8,3;19,8;28,1
25;"Iguaba Grande";2014;323;85;62;147;26,3;19,2;45,5
26;"Itaboraí";2014;3906;334;1611;1945;8,6;41,2;49,8
27;"Itaguaí";2014;1955;443;637;1080;22,7;32,6;55,2
28;"Italva(Cardoso Moreira)";2014;380;86;130;216;22,6;34,2;56,8
29;"Itaocara";2014;436;120;153;273;27,5;35,1;62,6
30;"Itaperuna";2014;1339;204;380;584;15,2;28,4;43,6
31;"Itatiaia";2014;342;97;75;172;28,4;21,9;50,3
32;"Japeri";2014;1203;93;516;609;7,7;42,9;50,6
33;"Laje do Muriaé";2014;95;28;27;55;29,5;28,4;57,9
34;"Macaé";2014;3350;382;1268;1650;11,4;37,9;49,3
35;"Magé";2014;3009;273;622;895;9,1;20,7;29,7
36;"Mangaratiba";2014;682;125;153;278;18,3;22,4;40,8
37;"Maricá";2014;2398;276;631;907;11,5;26,3;37,8
38;"Mendes";2014;185;19;25;44;10,3;13,5;23,8
40;"Miguel Pereira";2014;440;120;102;222;27,3;23,2;50,5
41;"Miracema";2014;462;94;136;230;20,3;29,4;49,8
42;"Natividade";2014;301;117;85;202;38,9;28,2;67,1
43;"Nilópolis";2014;243;6;55;61;2,5;22,6;25,1
44;"Niterói";2014;6563;1313;2354;3667;20;35,9;55,9
45;"Nova Friburgo";2014;4489;605;1632;2237;13,5;36,4;49,8
46;"Nova Iguaçu";2014;12842;1599;8533;10132;12,5;66,4;78,9
47;"Paracambi";2014;775;165;234;399;21,3;30,2;51,5
48;"Paraíba do Sul";2014;800;225;151;376;28,1;18,9;47
49;"Paraty";2014;652;83;178;261;12,7;27,3;40
50;"Paty do Alferes";2014;231;59;44;103;25,5;19;44,6
51;"Petrópolis";2014;2454;886;800;1686;36,1;32,6;68,7
52;"Pinheiral";2014;418;60;156;216;14,4;37,3;51,7
53;"Piraí";2014;294;60;127;187;20,4;43,2;63,6
54;"Porciúncula";2014;488;109;120;229;22,3;24,6;46,9
55;"Porto Real-Quatis";2014;360;72;127;199;20;35,3;55,3
56;"Queimados";2014;1208;192;414;606;15,9;34,3;50,2
57;"Resende";2014;2055;372;695;1067;18,1;33,8;51,9
58;"Rio Bonito";2014;609;113;144;257;18,6;23,6;42,2
59;"Rio Claro";2014;368;44;31;75;12;8,4;20,4
60;"Rio Das Flores";2014;140;21;59;80;15;42,1;57,1
61;"Rio Das Ostras";2014;1800;426;677;1103;23,7;37,6;61,3
62;"Santa Maria Madalena";2014;176;33;66;99;18,8;37,5;56,2
63;"Santo Antônio de Pádua";2014;928;134;376;510;14,4;40,5;55
64;"São Fidélis";2014;554;121;182;303;21,8;32,9;54,7
65;"São Francisco do Itabapoana";2014;664;86;177;263;13;26,7;39,6
66;"São Gonçalo";2014;9215;1245;4348;5593;13,5;47,2;60,7
67;"São João da Barra";2014;952;222;205;427;23,3;21,5;44,9
68;"São João de Meriti";2014;205;2;36;38;1;17,6;18,5
69;"São José do Vale do Rio Preto";2014;425;28;72;100;6,6;16,9;23,5
70;"São Pedro da Aldeia";2014;1354;171;532;703;12,6;39,3;51,9
71;"São Sebastião do Alto";2014;107;8;38;46;7,5;35,5;43
72;"Sapucaia";2014;477;51;182;233;10,7;38,2;48,8
73;"Saquarema";2014;96;9;8;17;9,4;8,3;17,7
74;"Seropédica";2014;1015;49;275;324;4,8;27,1;31,9
75;"Silva Jardim";2014;174;29;47;76;16,7;27;43,7
76;"Sumidouro";2014;178;52;42;94;29,2;23,6;52,8
78;"Teresópolis";2014;2566;555;722;1277;21,6;28,1;49,8
79;"Trajano de Moraes";2014;185;21;95;116;11,4;51,4;62,7
80;"Três Rios";2014;1485;363;332;695;24,4;22,4;46,8
81;"Valença";2014;1501;253;473;726;16,9;31,5;48,4
82;"Vassouras";2014;717;117;122;239;16,3;17;33,3
83;"Volta Redonda";2014;2051;558;582;1140;27,2;28,4;55,6
1;"Angra dos Reis";2013;2338;300;1172;1472;12,8;50,1;63
2;"Araruama";2013;2167;134;755;889;6,2;34,8;41
3;"Armação dos Búzios";2013;657;125;193;318;19;29,4;48,4
4;"Arraial do Cabo";2013;646;90;227;317;13,9;35,1;49,1
5;"Barra do Piraí";2013;964;156;281;437;16,2;29,1;45,3
6;"Barra Mansa";2013;1910;429;601;1030;22,5;31,5;53,9
7;"Belford Roxo";2013;473;8;19;27;1,7;4;5,7
8;"Bom Jardim";2013;590;56;216;272;9,5;36,6;46,1
9;"Bom Jesus do Itabapoana";2013;482;90;100;190;18,7;20,7;39,4
10;"Cabo Frio";2013;4211;741;2335;3076;17,6;55,5;73
11;"Cachoeiras de Macacu";2013;1025;141;388;529;13,8;37,9;51,6
12;"Cambuci";2013;177;24;60;84;13,6;33,9;47,5
13;"Campos dos Goytacazes";2013;5146;586;1012;1598;11,4;19,7;31,1
14;"Cantagalo";2013;637;99;326;425;15,5;51,2;66,7
15;"Rio de Janeiro";2013;80722;13566;30870;44436;16,8;38,2;55
16;"Carapebus/Quissamã";2013;889;60;367;427;6,7;41,3;48
17;"Carmo";2013;276;80;60;140;29;21,7;50,7
18;"Casimiro de Abreu";2013;475;85;117;202;17,9;24,6;42,5
19;"Conceição de Macabu";2013;298;43;116;159;14,4;38,9;53,4
20;"Cordeiro";2013;549;119;239;358;21,7;43,5;65,2
21;"Duas Barras";2013;370;32;100;132;8,6;27;35,7
22;"Duque de Caxias";2013;18505;2540;12965;15505;13,7;70,1;83,8
23;"Engenheiro Paulo de Frontin";2013;262;27;152;179;10,3;58;68,3
24;"Guapimirim";2013;1503;93;292;385;6,2;19,4;25,6
25;"Iguaba Grande";2013;311;70;53;123;22,5;17;39,5
26;"Itaboraí";2013;3222;288;1275;1563;8,9;39,6;48,5
27;"Itaguaí";2013;1284;312;549;861;24,3;42,8;67,1
28;"Italva(Cardoso Moreira)";2013;441;92;154;246;20,9;34,9;55,8
29;"Itaocara";2013;266;45;59;104;16,9;22,2;39,1
30;"Itaperuna";2013;982;123;351;474;12,5;35,7;48,3
31;"Itatiaia";2013;436;94;123;217;21,6;28,2;49,8
32;"Japeri";2013;1315;100;550;650;7,6;41,8;49,4
33;"Laje do Muriaé";2013;89;18;13;31;20,2;14,6;34,8
34;"Macaé";2013;3251;297;1210;1507;9,1;37,2;46,4
35;"Magé";2013;3162;189;590;779;6;18,7;24,6
36;"Mangaratiba";2013;606;86;159;245;14,2;26,2;40,4
37;"Maricá";2013;1386;137;407;544;9,9;29,4;39,2
38;"Mendes";2013;120;11;16;27;9,2;13,3;22,5
40;"Miguel Pereira";2013;213;72;65;137;33,8;30,5;64,3
41;"Miracema";2013;436;74;114;188;17;26,1;43,1
42;"Natividade";2013;266;107;63;170;40,2;23,7;63,9
43;"Nilópolis";2013;208;3;30;33;1,4;14,4;15,9
44;"Niterói";2013;6629;1185;2125;3310;17,9;32,1;49,9
45;"Nova Friburgo";2013;3946;511;1728;2239;12,9;43,8;56,7
46;"Nova Iguaçu";2013;13920;1986;9644;11630;14,3;69,3;83,5
47;"Paracambi";2013;578;132;148;280;22,8;25,6;48,4
48;"Paraíba do Sul";2013;689;150;133;283;21,8;19,3;41,1
49;"Paraty";2013;454;111;94;205;24,4;20,7;45,2
50;"Paty do Alferes";2013;160;58;44;102;36,2;27,5;63,8
51;"Petrópolis";2013;3018;1009;1027;2036;33,4;34;67,5
52;"Pinheiral";2013;226;9;56;65;4;24,8;28,8
53;"Piraí";2013;407;124;140;264;30,5;34,4;64,9
54;"Porciúncula";2013;374;101;94;195;27;25,1;52,1
55;"Porto Real-Quatis";2013;344;84;70;154;24,4;20,3;44,8
56;"Queimados";2013;824;98;334;432;11,9;40,5;52,4
57;"Resende";2013;1126;180;374;554;16;33,2;49,2
58;"Rio Bonito";2013;522;96;109;205;18,4;20,9;39,3
59;"Rio Claro";2013;478;58;96;154;12,1;20,1;32,2
60;"Rio Das Flores";2013;172;22;68;90;12,8;39,5;52,3
61;"Rio Das Ostras";2013;1577;363;711;1074;23;45,1;68,1
62;"Santa Maria Madalena";2013;209;30;65;95;14,4;31,1;45,5
63;"Santo Antônio de Pádua";2013;871;124;360;484;14,2;41,3;55,6
64;"São Fidélis";2013;546;151;117;268;27,7;21,4;49,1
65;"São Francisco do Itabapoana";2013;1085;93;278;371;8,6;25,6;34,2
66;"São Gonçalo";2013;9313;954;4838;5792;10,2;51,9;62,2
67;"São João da Barra";2013;2064;239;622;861;11,6;30,1;41,7
68;"São João de Meriti";2013;155;2;21;23;1,3;13,5;14,8
69;"São José do Vale do Rio Preto";2013;255;25;42;67;9,8;16,5;26,3
70;"São Pedro da Aldeia";2013;775;119;210;329;15,4;27,1;42,5
71;"São Sebastião do Alto";2013;122;14;29;43;11,5;23,8;35,2
72;"Sapucaia";2013;347;65;103;168;18,7;29,7;48,4
73;"Saquarema";2013;423;40;138;178;9,5;32,6;42,1
74;"Seropédica";2013;813;55;238;293;6,8;29,3;36
75;"Silva Jardim";2013;268;32;66;98;11,9;24,6;36,6
76;"Sumidouro";2013;144;33;44;77;22,9;30,6;53,5
78;"Teresópolis";2013;2862;433;891;1324;15,1;31,1;46,3
79;"Trajano de Moraes";2013;191;23;86;109;12;45;57,1
80;"Três Rios";2013;1537;454;345;799;29,5;22,4;52
81;"Valença";2013;1580;242;604;846;15,3;38,2;53,5
82;"Vassouras";2013;931;100;136;236;10,7;14,6;25,3
83;"Volta Redonda";2013;2373;660;814;1474;27,8;34,3;62,1
1;"Angra dos Reis";2012;2489;211;1277;1488;8,5;51,3;59,8
2;"Araruama";2012;3014;119;1436;1555;3,9;47,6;51,6
3;"Armação dos Búzios";2012;485;73;125;198;15,1;25,8;40,8
4;"Arraial do Cabo";2012;595;80;246;326;13,4;41,3;54,8
5;"Barra do Piraí";2012;968;70;343;413;7,2;35,4;42,7
6;"Barra Mansa";2012;1632;452;562;1014;27,7;34,4;62,1
7;"Belford Roxo";2012;904;3;66;69;0,3;7,3;7,6
8;"Bom Jardim";2012;556;48;133;181;8,6;23,9;32,6
9;"Bom Jesus do Itabapoana";2012;350;54;49;103;15,4;14;29,4
10;"Cabo Frio";2012;4069;495;2448;2943;12,2;60,2;72,3
11;"Cachoeiras de Macacu";2012;1167;155;295;450;13,3;25,3;38,6
12;"Cambuci";2012;246;32;92;124;13;37,4;50,4
13;"Campos dos Goytacazes";2012;5719;527;1117;1644;9,2;19,5;28,7
14;"Cantagalo";2012;446;76;138;214;17;30,9;48
15;"Rio de Janeiro";2012;76995;13233;34684;47917;17,2;45;62,2
16;"Carapebus/Quissamã";2012;792;63;351;414;8;44,3;52,3
17;"Carmo";2012;320;76;97;173;23,8;30,3;54,1
18;"Casimiro de Abreu";2012;598;106;179;285;17,7;29,9;47,7
19;"Conceição de Macabu";2012;300;28;113;141;9,3;37,7;47
20;"Cordeiro";2012;476;94;138;232;19,7;29;48,7
21;"Duas Barras";2012;353;30;109;139;8,5;30,9;39,4
22;"Duque de Caxias";2012;18142;1857;12704;14561;10,2;70;80,3
23;"Engenheiro Paulo de Frontin";2012;192;34;72;106;17,7;37,5;55,2
24;"Guapimirim";2012;1435;54;298;352;3,8;20,8;24,5
25;"Iguaba Grande";2012;257;55;66;121;21,4;25,7;47,1
26;"Itaboraí";2012;6048;456;2012;2468;7,5;33,3;40,8
27;"Itaguaí";2012;1776;285;1070;1355;16;60,2;76,3
28;"Italva(Cardoso Moreira)";2012;367;83;131;214;22,6;35,7;58,3
29;"Itaocara";2012;217;51;58;109;23,5;26,7;50,2
30;"Itaperuna";2012;903;97;311;408;10,7;34,4;45,2
31;"Itatiaia";2012;335;75;95;170;22,4;28,4;50,7
32;"Japeri";2012;2027;166;641;807;8,2;31,6;39,8
33;"Laje do Muriaé";2012;86;23;24;47;26,7;27,9;54,7
34;"Macaé";2012;2973;350;1246;1596;11,8;41,9;53,7
35;"Magé";2012;2715;203;541;744;7,5;19,9;27,4
36;"Mangaratiba";2012;952;112;436;548;11,8;45,8;57,6
37;"Maricá";2012;1831;203;674;877;11,1;36,8;47,9
38;"Mendes";2012;101;6;25;31;5,9;24,8;30,7
40;"Miguel Pereira";2012;229;52;93;145;22,7;40,6;63,3
41;"Miracema";2012;470;116;117;233;24,7;24,9;49,6
42;"Natividade";2012;249;96;65;161;38,6;26,1;64,7
43;"Nilópolis";2012;203;2;35;37;1;17,2;18,2
44;"Niterói";2012;6511;1338;2303;3641;20,5;35,4;55,9
45;"Nova Friburgo";2012;2635;467;1049;1516;17,7;39,8;57,5
46;"Nova Iguaçu";2012;12530;1967;8569;10536;15,7;68,4;84,1
47;"Paracambi";2012;621;107;158;265;17,2;25,4;42,7
48;"Paraíba do Sul";2012;662;163;166;329;24,6;25,1;49,7
49;"Paraty";2012;480;150;72;222;31,2;15;46,2
50;"Paty do Alferes";2012;150;48;56;104;32;37,3;69,3
51;"Petrópolis";2012;3438;1366;1003;2369;39,7;29,2;68,9
52;"Pinheiral";2012;175;11;83;94;6,3;47,4;53,7
53;"Piraí";2012;409;69;129;198;16,9;31,5;48,4
54;"Porciúncula";2012;369;92;92;184;24,9;24,9;49,9
55;"Porto Real-Quatis";2012;415;27;129;156;6,5;31,1;37,6
56;"Queimados";2012;538;6;87;93;1,1;16,2;17,3
57;"Resende";2012;1357;148;379;527;10,9;27,9;38,8
58;"Rio Bonito";2012;669;105;181;286;15,7;27,1;42,8
59;"Rio Claro";2012;376;43;166;209;11,4;44,1;55,6
60;"Rio Das Flores";2012;106;21;46;67;19,8;43,4;63,2
61;"Rio Das Ostras";2012;1465;262;718;980;17,9;49;66,9
62;"Santa Maria Madalena";2012;215;25;71;96;11,6;33;44,7
63;"Santo Antônio de Pádua";2012;796;101;239;340;12,7;30;42,7
64;"São Fidélis";2012;351;91;135;226;25,9;38,5;64,4
65;"São Francisco do Itabapoana";2012;1099;90;521;611;8,2;47,4;55,6
66;"São Gonçalo";2012;6771;756;3665;4421;11,2;54,1;65,3
67;"São João da Barra";2012;1081;172;302;474;15,9;27,9;43,8
68;"São João de Meriti";2012;1704;2;93;95;0,1;5,5;5,6
69;"São José do Vale do Rio Preto";2012;155;24;41;65;15,5;26,5;41,9
70;"São Pedro da Aldeia";2012;1194;135;311;446;11,3;26;37,4
71;"São Sebastião do Alto";2012;109;9;21;30;8,3;19,3;27,5
72;"Sapucaia";2012;249;45;57;102;18,1;22,9;41
73;"Saquarema";2012;915;77;283;360;8,4;30,9;39,3
74;"Seropédica";2012;833;82;284;366;9,8;34,1;43,9
75;"Silva Jardim";2012;357;40;87;127;11,2;24,4;35,6
76;"Sumidouro";2012;102;32;27;59;31,4;26,5;57,8
78;"Teresópolis";2012;2530;542;894;1436;21,4;35,3;56,8
79;"Trajano de Moraes";2012;147;12;81;93;8,2;55,1;63,3
80;"Três Rios";2012;1562;394;455;849;25,2;29,1;54,4
81;"Valença";2012;645;166;254;420;25,7;39,4;65,1
82;"Vassouras";2012;789;120;402;522;15,2;51;66,2
83;"Volta Redonda";2012;2207;680;777;1457;30,8;35,2;66
1;"Angra dos Reis";2011;2662;135;1593;1728;5,1;59,8;64,9
2;"Araruama";2011;2370;104;1271;1375;4,4;53,6;58
3;"Armação dos Búzios";2011;667;48;308;356;7,2;46,2;53,4
4;"Arraial do Cabo";2011;762;26;340;366;3,4;44,6;48
5;"Barra do Piraí";2011;1080;89;388;477;8,2;35,9;44,2
6;"Barra Mansa";2011;1608;400;519;919;24,9;32,3;57,2
7;"Belford Roxo";2011;423;3;25;28;0,7;5,9;6,6
8;"Bom Jardim";2011;415;40;223;263;9,6;53,7;63,4
9;"Bom Jesus do Itabapoana";2011;475;50;101;151;10,5;21,3;31,8
10;"Cabo Frio";2011;3838;317;1809;2126;8,3;47,1;55,4
11;"Cachoeiras de Macacu";2011;974;120;290;410;12,3;29,8;42,1
12;"Cambuci";2011;277;33;73;106;11,9;26,4;38,3
13;"Campos dos Goytacazes";2011;5866;702;1434;2136;12;24,4;36,4
14;"Cantagalo";2011;253;57;47;104;22,5;18,6;41,1
15;"Rio de Janeiro";2011;86109;13060;41730;54790;15,2;48,5;63,6
16;"Carapebus/Quissamã";2011;795;60;352;412;7,5;44,3;51,8
17;"Carmo";2011;264;59;65;124;22,3;24,6;47
18;"Casimiro de Abreu";2011;1016;92;336;428;9,1;33,1;42,1
19;"Conceição de Macabu";2011;808;55;341;396;6,8;42,2;49
20;"Cordeiro";2011;495;55;111;166;11,1;22,4;33,5
21;"Duas Barras";2011;196;10;62;72;5,1;31,6;36,7
22;"Duque de Caxias";2011;16956;2085;11904;13989;12,3;70,2;82,5
23;"Engenheiro Paulo de Frontin";2011;177;16;79;95;9;44,6;53,7
24;"Guapimirim";2011;285;30;75;105;10,5;26,3;36,8
25;"Iguaba Grande";2011;222;37;49;86;16,7;22,1;38,7
26;"Itaboraí";2011;5640;284;3968;4252;5;70,4;75,4
27;"Itaguaí";2011;1420;246;750;996;17,3;52,8;70,1
28;"Italva(Cardoso Moreira)";2011;439;66;139;205;15;31,7;46,7
29;"Itaocara";2011;256;30;91;121;11,7;35,5;47,3
30;"Itaperuna";2011;893;71;288;359;8;32,3;40,2
31;"Itatiaia";2011;307;68;99;167;22,1;32,2;54,4
32;"Japeri";2011;1024;42;270;312;4,1;26,4;30,5
33;"Laje do Muriaé";2011;71;14;21;35;19,7;29,6;49,3
34;"Macaé";2011;5596;284;2616;2900;5,1;46,7;51,8
35;"Magé";2011;2909;125;525;650;4,3;18;22,3
36;"Mangaratiba";2011;1168;80;715;795;6,8;61,2;68,1
37;"Maricá";2011;1458;195;500;695;13,4;34,3;47,7
38;"Mendes";2011;46;2;18;20;4,3;39,1;43,5
40;"Miguel Pereira";2011;314;73;138;211;23,2;43,9;67,2
41;"Miracema";2011;711;102;221;323;14,3;31,1;45,4
42;"Natividade";2011;269;84;84;168;31,2;31,2;62,5
43;"Nilópolis";2011;198;1;42;43;0,5;21,2;21,7
44;"Niterói";2011;6068;1233;2867;4100;20,3;47,2;67,6
45;"Nova Friburgo";2011;4014;257;1698;1955;6,4;42,3;48,7
46;"Nova Iguaçu";2011;16640;1661;10814;12475;10;65;75
47;"Paracambi";2011;864;82;265;347;9,5;30,7;40,2
48;"Paraíba do Sul";2011;553;108;95;203;19,5;17,2;36,7
49;"Paraty";2011;438;138;95;233;31,5;21,7;53,2
50;"Paty do Alferes";2011;57;17;19;36;29,8;33,3;63,2
51;"Petrópolis";2011;2329;989;627;1616;42,5;26,9;69,4
52;"Pinheiral";2011;301;29;171;200;9,6;56,8;66,4
53;"Piraí";2011;428;41;146;187;9,6;34,1;43,7
54;"Porciúncula";2011;581;72;157;229;12,4;27;39,4
55;"Porto Real-Quatis";2011;425;54;98;152;12,7;23,1;35,8
56;"Queimados";2011;715;18;148;166;2,5;20,7;23,2
57;"Resende";2011;3850;178;897;1075;4,6;23,3;27,9
58;"Rio Bonito";2011;512;47;124;171;9,2;24,2;33,4
59;"Rio Claro";2011;299;26;109;135;8,7;36,5;45,2
60;"Rio Das Flores";2011;91;11;6;17;12,1;6,6;18,7
61;"Rio Das Ostras";2011;1448;162;733;895;11,2;50,6;61,8
62;"Santa Maria Madalena";2011;124;16;55;71;12,9;44,4;57,3
63;"Santo Antônio de Pádua";2011;808;92;385;477;11,4;47,6;59
64;"São Fidélis";2011;391;106;139;245;27,1;35,5;62,7
65;"São Francisco do Itabapoana";2011;563;45;150;195;8;26,6;34,6
66;"São Gonçalo";2011;8591;651;4817;5468;7,6;56,1;63,6
67;"São João da Barra";2011;995;88;320;408;8,8;32,2;41
68;"São João de Meriti";2011;1986;5;136;141;0,3;6,8;7,1
69;"São José do Vale do Rio Preto";2011;187;14;79;93;7,5;42,2;49,7
70;"São Pedro da Aldeia";2011;1126;184;262;446;16,3;23,3;39,6
71;"São Sebastião do Alto";2011;144;10;25;35;6,9;17,4;24,3
72;"Sapucaia";2011;902;57;195;252;6,3;21,6;27,9
73;"Saquarema";2011;1792;121;694;815;6,8;38,7;45,5
74;"Seropédica";2011;991;48;412;460;4,8;41,6;46,4
75;"Silva Jardim";2011;412;23;87;110;5,6;21,1;26,7
76;"Sumidouro";2011;150;40;44;84;26,7;29,3;56
78;"Teresópolis";2011;2941;372;889;1261;12,6;30,2;42,9
79;"Trajano de Moraes";2011;123;20;67;87;16,3;54,5;70,7
80;"Três Rios";2011;2073;425;987;1412;20,5;47,6;68,1
81;"Valença";2011;1040;210;281;491;20,2;27;47,2
82;"Vassouras";2011;342;45;205;250;13,2;59,9;73,1
83;"Volta Redonda";2011;2408;630;924;1554;26,2;38,4;64,5
1;"Angra dos Reis";2010;5843;229;4967;5196;3,9;85;88,9
2;"Araruama";2010;1242;63;760;823;5,1;61,2;66,3
3;"Armação dos Búzios";2010;700;87;362;449;12,4;51,7;64,1
4;"Arraial do Cabo";2010;184;5;77;82;2,7;41,8;44,6
5;"Barra do Piraí";2010;1747;187;1087;1274;10,7;62,2;72,9
6;"Barra Mansa";2010;4502;600;2857;3457;13,3;63,5;76,8
7;"Belford Roxo";2010;40;0;3;3;0;7,5;7,5
8;"Bom Jardim";2010;245;25;116;141;10,2;47,3;57,6
9;"Bom Jesus do Itabapoana";2010;301;17;46;63;5,6;15,3;20,9
10;"Cabo Frio";2010;2520;146;1505;1651;5,8;59,7;65,5
11;"Cachoeiras de Macacu";2010;1427;112;437;549;7,8;30,6;38,5
12;"Cambuci";2010;301;36;162;198;12;53,8;65,8
13;"Campos dos Goytacazes";2010;13682;1369;7034;8403;10;51,4;61,4
14;"Cantagalo";2010;304;67;158;225;22;52;74
15;"Rio de Janeiro";2010;52427;10230;29956;40186;19,5;57,1;76,7
16;"Carapebus/Quissamã";2010;932;69;529;598;7,4;56,8;64,2
17;"Carmo";2010;223;55;51;106;24,7;22,9;47,5
18;"Casimiro de Abreu";2010;1374;97;411;508;7,1;29,9;37
19;"Conceição de Macabu";2010;197;16;142;158;8,1;72,1;80,2
20;"Cordeiro";2010;536;53;153;206;9,9;28,5;38,4
21;"Duas Barras";2010;131;20;48;68;15,3;36,6;51,9
22;"Duque de Caxias";2010;13250;2589;9127;11716;19,5;68,9;88,4
23;"Engenheiro Paulo de Frontin";2010;198;27;106;133;13,6;53,5;67,2
24;"Guapimirim";2010;52;4;14;18;7,7;26,9;34,6
25;"Iguaba Grande";2010;262;66;90;156;25,2;34,4;59,5
26;"Itaboraí";2010;2959;190;1971;2161;6,4;66,6;73
27;"Itaguaí";2010;2953;213;1884;2097;7,2;63,8;71
28;"Italva(Cardoso Moreira)";2010;227;32;86;118;14,1;37,9;52
29;"Itaocara";2010;289;26;86;112;9;29,8;38,8
30;"Itaperuna";2010;623;41;178;219;6,6;28,6;35,2
31;"Itatiaia";2010;363;102;170;272;28,1;46,8;74,9
32;"Japeri";2010;893;25;246;271;2,8;27,5;30,3
33;"Laje do Muriaé";2010;37;5;4;9;13,5;10,8;24,3
34;"Macaé";2010;4922;150;1680;1830;3;34,1;37,2
35;"Magé";2010;4410;169;1626;1795;3,8;36,9;40,7
36;"Mangaratiba";2010;457;29;274;303;6,3;60;66,3
37;"Maricá";2010;3821;351;2427;2778;9,2;63,5;72,7
38;"Mendes";2010;138;3;45;48;2,2;32,6;34,8
40;"Miguel Pereira";2010;297;81;152;233;27,3;51,2;78,5
41;"Miracema";2010;620;81;317;398;13,1;51,1;64,2
42;"Natividade";2010;173;85;58;143;49,1;33,5;82,7
43;"Nilópolis";2010;118;0;34;34;0;28,8;28,8
44;"Niterói";2010;5632;1027;3933;4960;18,2;69,8;88,1
45;"Nova Friburgo";2010;1160;153;486;639;13,2;41,9;55,1
46;"Nova Iguaçu";2010;10572;1487;7848;9335;14,1;74,2;88,3
47;"Paracambi";2010;768;61;368;429;7,9;47,9;55,9
48;"Paraíba do Sul";2010;929;150;389;539;16,1;41,9;58
49;"Paraty";2010;1231;158;679;837;12,8;55,2;68
50;"Paty do Alferes";2010;12;1;6;7;8,3;50;58,3
51;"Petrópolis";2010;3021;1014;1186;2200;33,6;39,3;72,8
52;"Pinheiral";2010;26;4;15;19;15,4;57,7;73,1
53;"Piraí";2010;353;35;145;180;9,9;41,1;51
54;"Porciúncula";2010;373;75;144;219;20,1;38,6;58,7
55;"Porto Real-Quatis";2010;554;78;193;271;14,1;34,8;48,9
56;"Queimados";2010;20;1;8;9;5;40;45
57;"Resende";2010;2618;152;996;1148;5,8;38;43,9
58;"Rio Bonito";2010;1248;84;744;828;6,7;59,6;66,3
59;"Rio Claro";2010;307;26;151;177;8,5;49,2;57,7
60;"Rio Das Flores";2010;77;0;4;4;0;5,2;5,2
61;"Rio Das Ostras";2010;722;97;358;455;13,4;49,6;63
62;"Santa Maria Madalena";2010;233;22;88;110;9,4;37,8;47,2
63;"Santo Antônio de Pádua";2010;1762;117;763;880;6,6;43,3;49,9
64;"São Fidélis";2010;523;109;241;350;20,8;46,1;66,9
65;"São Francisco do Itabapoana";2010;1250;56;398;454;4,5;31,8;36,3
66;"São Gonçalo";2010;6195;543;4304;4847;8,8;69,5;78,2
67;"São João da Barra";2010;798;59;233;292;7,4;29,2;36,6
68;"São João de Meriti";2010;148;1;64;65;0,7;43,2;43,9
69;"São José do Vale do Rio Preto";2010;227;19;137;156;8,4;60,4;68,7
70;"São Pedro da Aldeia";2010;1671;212;1011;1223;12,7;60,5;73,2
71;"São Sebastião do Alto";2010;109;16;19;35;14,7;17,4;32,1
72;"Sapucaia";2010;327;21;13;34;6,4;4;10,4
73;"Saquarema";2010;355;36;170;206;10,1;47,9;58
74;"Seropédica";2010;2072;89;1353;1442;4,3;65,3;69,6
75;"Silva Jardim";2010;190;8;16;24;4,2;8,4;12,6
76;"Sumidouro";2010;91;46;22;68;50,5;24,2;74,7
78;"Teresópolis";2010;4694;525;3145;3670;11,2;67;78,2
79;"Trajano de Moraes";2010;107;28;65;93;26,2;60,7;86,9
80;"Três Rios";2010;588;148;340;488;25,2;57,8;83
81;"Valença";2010;1418;164;873;1037;11,6;61,6;73,1
82;"Vassouras";2010;959;47;813;860;4,9;84,8;89,7
83;"Volta Redonda";2010;2752;650;1140;1790;23,6;41,4;65
