"codigo_comarca";"nome_comarca";"ano";"novos";"denuncias";"arquivamentos";"finalizados";"taxa_denuncia";"taxa_arquivamento";"taxa_finalizacao"
1;"Angra dos Reis";2021;81;0;1;1;0;1,2;1,2
2;"Araruama";2021;17;0;0;0;0;0;0
3;"Armação dos Búzios";2021;50;8;1;9;16;2;18
4;"Arraial do Cabo";2021;31;0;0;0;0;0;0
5;"Barra do Piraí";2021;268;11;17;28;4,1;6,3;10,4
6;"Barra Mansa";2021;277;6;3;9;2,2;1,1;3,2
7;"Belford Roxo";2021;27;0;0;0;0;0;0
8;"Bom Jardim";2021;33;1;1;2;3;3;6,1
9;"Bom Jesus do Itabapoana";2021;88;0;0;0;0;0;0
10;"Cabo Frio";2021;212;18;18;36;8,5;8,5;17
11;"Cachoeiras de Macacu";2021;126;3;4;7;2,4;3,2;5,6
12;"Cambuci";2021;28;1;3;4;3,6;10,7;14,3
13;"Campos dos Goytacazes";2021;346;8;2;10;2,3;0,6;2,9
14;"Cantagalo";2021;59;0;11;11;0;18,6;18,6
15;"Rio de Janeiro";2021;7711;579;208;787;7,5;2,7;10,2
16;"Carapebus/Quissamã";2021;73;0;0;0;0;0;0
17;"Carmo";2021;34;4;4;8;11,8;11,8;23,5
18;"Casimiro de Abreu";2021;86;0;1;1;0;1,2;1,2
19;"Conceição de Macabu";2021;24;0;1;1;0;4,2;4,2
20;"Cordeiro";2021;68;1;2;3;1,5;2,9;4,4
21;"Duas Barras";2021;20;0;0;0;0;0;0
22;"Duque de Caxias";2021;1832;78;45;123;4,3;2,5;6,7
23;"Engenheiro Paulo de Frontin";2021;34;0;1;1;0;2,9;2,9
24;"Guapimirim";2021;51;7;2;9;13,7;3,9;17,6
25;"Iguaba Grande";2021;64;0;0;0;0;0;0
26;"Itaboraí";2021;73;8;6;14;11;8,2;19,2
27;"Itaguaí";2021;51;2;7;9;3,9;13,7;17,6
28;"Italva(Cardoso Moreira)";2021;36;0;1;1;0;2,8;2,8
29;"Itaocara";2021;37;6;1;7;16,2;2,7;18,9
30;"Itaperuna";2021;65;3;2;5;4,6;3,1;7,7
31;"Itatiaia";2021;77;13;6;19;16,9;7,8;24,7
32;"Japeri";2021;397;11;1;12;2,8;0,3;3
33;"Laje do Muriaé";2021;21;1;2;3;4,8;9,5;14,3
34;"Macaé";2021;299;0;5;5;0;1,7;1,7
35;"Magé";2021;205;4;18;22;2;8,8;10,7
36;"Mangaratiba";2021;178;24;26;50;13,5;14,6;28,1
37;"Maricá";2021;128;1;14;15;0,8;10,9;11,7
38;"Mendes";2021;41;2;3;5;4,9;7,3;12,2
40;"Miguel Pereira";2021;93;3;4;7;3,2;4,3;7,5
41;"Miracema";2021;105;10;12;22;9,5;11,4;21
42;"Natividade";2021;48;0;0;0;0;0;0
43;"Nilópolis";2021;14;0;0;0;0;0;0
44;"Niterói";2021;894;29;26;55;3,2;2,9;6,2
45;"Nova Friburgo";2021;334;10;38;48;3;11,4;14,4
46;"Nova Iguaçu";2021;1211;81;62;143;6,7;5,1;11,8
47;"Paracambi";2021;68;15;2;17;22,1;2,9;25
48;"Paraíba do Sul";2021;163;16;18;34;9,8;11;20,9
49;"Paraty";2021;147;3;6;9;2;4,1;6,1
50;"Paty do Alferes";2021;71;2;0;2;2,8;0;2,8
51;"Petrópolis";2021;442;30;11;41;6,8;2,5;9,3
52;"Pinheiral";2021;48;3;7;10;6,2;14,6;20,8
53;"Piraí";2021;61;10;2;12;16,4;3,3;19,7
54;"Porciúncula";2021;104;7;8;15;6,7;7,7;14,4
55;"Porto Real-Quatis";2021;19;3;3;6;15,8;15,8;31,6
56;"Queimados";2021;52;14;5;19;26,9;9,6;36,5
57;"Resende";2021;443;14;19;33;3,2;4,3;7,4
58;"Rio Bonito";2021;70;11;3;14;15,7;4,3;20
59;"Rio Claro";2021;28;0;1;1;0;3,6;3,6
60;"Rio Das Flores";2021;5;0;0;0;0;0;0
61;"Rio Das Ostras";2021;348;8;15;23;2,3;4,3;6,6
62;"Santa Maria Madalena";2021;28;0;0;0;0;0;0
63;"Santo Antônio de Pádua";2021;236;10;9;19;4,2;3,8;8,1
64;"São Fidélis";2021;27;2;4;6;7,4;14,8;22,2
65;"São Francisco do Itabapoana";2021;78;0;2;2;0;2,6;2,6
66;"São Gonçalo";2021;685;53;40;93;7,7;5,8;13,6
67;"São João da Barra";2021;74;5;4;9;6,8;5,4;12,2
68;"São João de Meriti";2021;35;0;14;14;0;40;40
69;"São José do Vale do Rio Preto";2021;17;1;1;2;5,9;5,9;11,8
70;"São Pedro da Aldeia";2021;129;12;15;27;9,3;11,6;20,9
71;"São Sebastião do Alto";2021;39;0;0;0;0;0;0
72;"Sapucaia";2021;26;3;3;6;11,5;11,5;23,1
74;"Seropédica";2021;107;4;1;5;3,7;0,9;4,7
75;"Silva Jardim";2021;50;1;5;6;2;10;12
76;"Sumidouro";2021;18;0;3;3;0;16,7;16,7
78;"Teresópolis";2021;127;7;6;13;5,5;4,7;10,2
79;"Trajano de Moraes";2021;22;0;2;2;0;9,1;9,1
80;"Três Rios";2021;104;14;20;34;13,5;19,2;32,7
81;"Valença";2021;173;2;10;12;1,2;5,8;6,9
82;"Vassouras";2021;107;3;6;9;2,8;5,6;8,4
83;"Volta Redonda";2021;206;0;11;11;0;5,3;5,3
1;"Angra dos Reis";2020;1208;38;41;79;3,1;3,4;6,5
2;"Araruama";2020;1908;361;114;475;18,9;6;24,9
3;"Armação dos Búzios";2020;759;51;28;79;6,7;3,7;10,4
4;"Arraial do Cabo";2020;227;27;8;35;11,9;3,5;15,4
5;"Barra do Piraí";2020;1298;57;248;305;4,4;19,1;23,5
6;"Barra Mansa";2020;1358;194;109;303;14,3;8;22,3
7;"Belford Roxo";2020;452;0;2;2;0;0,4;0,4
8;"Bom Jardim";2020;182;24;21;45;13,2;11,5;24,7
9;"Bom Jesus do Itabapoana";2020;326;42;51;93;12,9;15,6;28,5
10;"Cabo Frio";2020;1630;306;291;597;18,8;17,9;36,6
11;"Cachoeiras de Macacu";2020;418;47;56;103;11,2;13,4;24,6
12;"Cambuci";2020;199;5;28;33;2,5;14,1;16,6
13;"Campos dos Goytacazes";2020;2490;463;76;539;18,6;3,1;21,6
14;"Cantagalo";2020;268;35;50;85;13,1;18,7;31,7
15;"Rio de Janeiro";2020;38065;7110;3060;10170;18,7;8;26,7
16;"Carapebus/Quissamã";2020;468;29;84;113;6,2;17,9;24,1
17;"Carmo";2020;415;48;114;162;11,6;27,5;39
18;"Casimiro de Abreu";2020;444;51;19;70;11,5;4,3;15,8
19;"Conceição de Macabu";2020;302;22;52;74;7,3;17,2;24,5
20;"Cordeiro";2020;319;50;59;109;15,7;18,5;34,2
21;"Duas Barras";2020;105;6;7;13;5,7;6,7;12,4
22;"Duque de Caxias";2020;9908;2046;1308;3354;20,6;13,2;33,9
23;"Engenheiro Paulo de Frontin";2020;162;14;36;50;8,6;22,2;30,9
24;"Guapimirim";2020;292;53;23;76;18,2;7,9;26
25;"Iguaba Grande";2020;292;53;25;78;18,2;8,6;26,7
26;"Itaboraí";2020;864;143;74;217;16,6;8,6;25,1
27;"Itaguaí";2020;771;160;105;265;20,8;13,6;34,4
28;"Italva(Cardoso Moreira)";2020;428;40;55;95;9,3;12,9;22,2
29;"Itaocara";2020;325;71;67;138;21,8;20,6;42,5
30;"Itaperuna";2020;1219;84;77;161;6,9;6,3;13,2
31;"Itatiaia";2020;292;75;31;106;25,7;10,6;36,3
32;"Japeri";2020;718;51;93;144;7,1;13;20,1
33;"Laje do Muriaé";2020;128;24;29;53;18,8;22,7;41,4
34;"Macaé";2020;1299;209;113;322;16,1;8,7;24,8
35;"Magé";2020;1551;96;385;481;6,2;24,8;31
36;"Mangaratiba";2020;410;34;41;75;8,3;10;18,3
37;"Maricá";2020;2339;58;151;209;2,5;6,5;8,9
38;"Mendes";2020;315;42;49;91;13,3;15,6;28,9
40;"Miguel Pereira";2020;315;36;40;76;11,4;12,7;24,1
41;"Miracema";2020;475;50;97;147;10,5;20,4;30,9
42;"Natividade";2020;202;25;38;63;12,4;18,8;31,2
43;"Nilópolis";2020;38;0;3;3;0;7,9;7,9
44;"Niterói";2020;3857;621;322;943;16,1;8,3;24,4
45;"Nova Friburgo";2020;1704;118;271;389;6,9;15,9;22,8
46;"Nova Iguaçu";2020;7108;1106;1191;2297;15,6;16,8;32,3
47;"Paracambi";2020;443;59;33;92;13,3;7,4;20,8
48;"Paraíba do Sul";2020;286;51;23;74;17,8;8;25,9
49;"Paraty";2020;454;32;30;62;7;6,6;13,7
50;"Paty do Alferes";2020;231;63;35;98;27,3;15,2;42,4
51;"Petrópolis";2020;2432;771;412;1183;31,7;16,9;48,6
52;"Pinheiral";2020;348;20;68;88;5,7;19,5;25,3
53;"Piraí";2020;261;54;53;107;20,7;20,3;41
54;"Porciúncula";2020;603;72;90;162;11,9;14,9;26,9
55;"Porto Real-Quatis";2020;126;24;13;37;19;10,3;29,4
56;"Queimados";2020;838;120;56;176;14,3;6,7;21
57;"Resende";2020;1610;147;83;230;9,1;5,2;14,3
58;"Rio Bonito";2020;302;64;10;74;21,2;3,3;24,5
59;"Rio Claro";2020;214;4;32;36;1,9;15;16,8
60;"Rio Das Flores";2020;68;20;6;26;29,4;8,8;38,2
61;"Rio Das Ostras";2020;1468;145;185;330;9,9;12,6;22,5
62;"Santa Maria Madalena";2020;75;0;16;16;0;21,3;21,3
63;"Santo Antônio de Pádua";2020;860;90;81;171;10,5;9,4;19,9
64;"São Fidélis";2020;288;53;22;75;18,4;7,6;26
65;"São Francisco do Itabapoana";2020;513;17;23;40;3,3;4,5;7,8
66;"São Gonçalo";2020;3947;709;541;1250;18;13,7;31,7
67;"São João da Barra";2020;463;153;43;196;33;9,3;42,3
68;"São João de Meriti";2020;191;5;20;25;2,6;10,5;13,1
69;"São José do Vale do Rio Preto";2020;212;9;17;26;4,2;8;12,3
70;"São Pedro da Aldeia";2020;678;124;120;244;18,3;17,7;36
71;"São Sebastião do Alto";2020;209;9;35;44;4,3;16,7;21,1
72;"Sapucaia";2020;306;44;56;100;14,4;18,3;32,7
73;"Saquarema";2020;23;0;4;4;0;17,4;17,4
74;"Seropédica";2020;730;108;71;179;14,8;9,7;24,5
75;"Silva Jardim";2020;349;66;81;147;18,9;23,2;42,1
76;"Sumidouro";2020;166;30;31;61;18,1;18,7;36,7
78;"Teresópolis";2020;1256;177;100;277;14,1;8;22,1
79;"Trajano de Moraes";2020;182;8;48;56;4,4;26,4;30,8
80;"Três Rios";2020;1345;290;164;454;21,6;12,2;33,8
81;"Valença";2020;847;60;142;202;7,1;16,8;23,8
82;"Vassouras";2020;652;36;86;122;5,5;13,2;18,7
83;"Volta Redonda";2020;2319;239;242;481;10,3;10,4;20,7
1;"Angra dos Reis";2019;2284;152;252;404;6,7;11;17,7
2;"Araruama";2019;2038;512;218;730;25,1;10,7;35,8
3;"Armação dos Búzios";2019;553;103;70;173;18,6;12,7;31,3
4;"Arraial do Cabo";2019;543;57;69;126;10,5;12,7;23,2
5;"Barra do Piraí";2019;2155;187;561;748;8,7;26;34,7
6;"Barra Mansa";2019;1941;367;288;655;18,9;14,8;33,7
7;"Belford Roxo";2019;5851;0;21;21;0;0,4;0,4
8;"Bom Jardim";2019;237;44;25;69;18,6;10,5;29,1
9;"Bom Jesus do Itabapoana";2019;478;76;117;193;15,9;24,5;40,4
10;"Cabo Frio";2019;4256;417;496;913;9,8;11,7;21,5
11;"Cachoeiras de Macacu";2019;484;77;64;141;15,9;13,2;29,1
12;"Cambuci";2019;307;23;37;60;7,5;12,1;19,5
13;"Campos dos Goytacazes";2019;3634;792;130;922;21,8;3,6;25,4
14;"Cantagalo";2019;269;48;78;126;17,8;29;46,8
15;"Rio de Janeiro";2019;54449;12438;6659;19097;22,8;12,2;35,1
16;"Carapebus/Quissamã";2019;586;85;84;169;14,5;14,3;28,8
17;"Carmo";2019;744;114;184;298;15,3;24,7;40,1
18;"Casimiro de Abreu";2019;706;73;78;151;10,3;11;21,4
19;"Conceição de Macabu";2019;321;33;42;75;10,3;13,1;23,4
20;"Cordeiro";2019;393;83;73;156;21,1;18,6;39,7
21;"Duas Barras";2019;262;20;50;70;7,6;19,1;26,7
22;"Duque de Caxias";2019;11768;2589;3180;5769;22;27;49
23;"Engenheiro Paulo de Frontin";2019;245;22;58;80;9;23,7;32,7
24;"Guapimirim";2019;636;122;71;193;19,2;11,2;30,3
25;"Iguaba Grande";2019;294;78;40;118;26,5;13,6;40,1
26;"Itaboraí";2019;2837;213;214;427;7,5;7,5;15,1
27;"Itaguaí";2019;1674;463;592;1055;27,7;35,4;63
28;"Italva(Cardoso Moreira)";2019;549;73;134;207;13,3;24,4;37,7
29;"Itaocara";2019;511;109;136;245;21,3;26,6;47,9
30;"Itaperuna";2019;2909;166;361;527;5,7;12,4;18,1
31;"Itatiaia";2019;248;54;58;112;21,8;23,4;45,2
32;"Japeri";2019;1733;217;247;464;12,5;14,3;26,8
33;"Laje do Muriaé";2019;164;31;39;70;18,9;23,8;42,7
34;"Macaé";2019;3662;319;245;564;8,7;6,7;15,4
35;"Magé";2019;2462;417;784;1201;16,9;31,8;48,8
36;"Mangaratiba";2019;805;54;83;137;6,7;10,3;17
37;"Maricá";2019;1113;54;86;140;4,9;7,7;12,6
38;"Mendes";2019;298;53;55;108;17,8;18,5;36,2
40;"Miguel Pereira";2019;331;69;72;141;20,8;21,8;42,6
41;"Miracema";2019;699;116;196;312;16,6;28;44,6
42;"Natividade";2019;233;38;44;82;16,3;18,9;35,2
43;"Nilópolis";2019;516;0;31;31;0;6;6
44;"Niterói";2019;5054;902;787;1689;17,8;15,6;33,4
45;"Nova Friburgo";2019;2218;306;529;835;13,8;23,9;37,6
46;"Nova Iguaçu";2019;11313;1941;4195;6136;17,2;37,1;54,2
47;"Paracambi";2019;602;70;100;170;11,6;16,6;28,2
48;"Paraíba do Sul";2019;454;146;43;189;32,2;9,5;41,6
49;"Paraty";2019;571;82;68;150;14,4;11,9;26,3
50;"Paty do Alferes";2019;346;78;66;144;22,5;19,1;41,6
51;"Petrópolis";2019;2801;1093;611;1704;39;21,8;60,8
52;"Pinheiral";2019;443;27;114;141;6,1;25,7;31,8
53;"Piraí";2019;296;72;95;167;24,3;32,1;56,4
54;"Porciúncula";2019;718;81;111;192;11,3;15,5;26,7
55;"Porto Real-Quatis";2019;183;39;27;66;21,3;14,8;36,1
56;"Queimados";2019;1089;254;97;351;23,3;8,9;32,2
57;"Resende";2019;3126;429;399;828;13,7;12,8;26,5
58;"Rio Bonito";2019;691;128;35;163;18,5;5,1;23,6
59;"Rio Claro";2019;827;45;256;301;5,4;31;36,4
60;"Rio Das Flores";2019;101;26;16;42;25,7;15,8;41,6
61;"Rio Das Ostras";2019;2626;195;352;547;7,4;13,4;20,8
62;"Santa Maria Madalena";2019;154;10;34;44;6,5;22,1;28,6
63;"Santo Antônio de Pádua";2019;949;102;158;260;10,7;16,6;27,4
64;"São Fidélis";2019;422;115;81;196;27,3;19,2;46,4
65;"São Francisco do Itabapoana";2019;793;58;59;117;7,3;7,4;14,8
66;"São Gonçalo";2019;4994;1226;798;2024;24,5;16;40,5
67;"São João da Barra";2019;501;166;36;202;33,1;7,2;40,3
68;"São João de Meriti";2019;190;5;11;16;2,6;5,8;8,4
69;"São José do Vale do Rio Preto";2019;220;17;32;49;7,7;14,5;22,3
70;"São Pedro da Aldeia";2019;1034;198;229;427;19,1;22,1;41,3
71;"São Sebastião do Alto";2019;716;11;83;94;1,5;11,6;13,1
72;"Sapucaia";2019;353;52;100;152;14,7;28,3;43,1
73;"Saquarema";2019;20;0;0;0;0;0;0
74;"Seropédica";2019;1255;194;127;321;15,5;10,1;25,6
75;"Silva Jardim";2019;197;69;49;118;35;24,9;59,9
76;"Sumidouro";2019;195;68;38;106;34,9;19,5;54,4
78;"Teresópolis";2019;2035;426;347;773;20,9;17,1;38
79;"Trajano de Moraes";2019;170;25;70;95;14,7;41,2;55,9
80;"Três Rios";2019;1697;516;272;788;30,4;16;46,4
81;"Valença";2019;1515;123;637;760;8,1;42;50,2
82;"Vassouras";2019;1064;80;159;239;7,5;14,9;22,5
83;"Volta Redonda";2019;2759;248;205;453;9;7,4;16,4
1;"Angra dos Reis";2018;1401;176;245;421;12,6;17,5;30
2;"Araruama";2018;2776;577;497;1074;20,8;17,9;38,7
3;"Armação dos Búzios";2018;547;103;72;175;18,8;13,2;32
4;"Arraial do Cabo";2018;495;83;108;191;16,8;21,8;38,6
5;"Barra do Piraí";2018;1667;293;478;771;17,6;28,7;46,3
6;"Barra Mansa";2018;1709;348;343;691;20,4;20,1;40,4
7;"Belford Roxo";2018;2285;2;9;11;0,1;0,4;0,5
8;"Bom Jardim";2018;228;39;38;77;17,1;16,7;33,8
9;"Bom Jesus do Itabapoana";2018;422;106;102;208;25,1;24,2;49,3
10;"Cabo Frio";2018;4201;410;879;1289;9,8;20,9;30,7
11;"Cachoeiras de Macacu";2018;450;62;75;137;13,8;16,7;30,4
12;"Cambuci";2018;186;17;24;41;9,1;12,9;22
13;"Campos dos Goytacazes";2018;2457;455;92;547;18,5;3,7;22,3
14;"Cantagalo";2018;248;69;74;143;27,8;29,8;57,7
15;"Rio de Janeiro";2018;52975;13425;8787;22212;25,3;16,6;41,9
16;"Carapebus/Quissamã";2018;640;98;91;189;15,3;14,2;29,5
17;"Carmo";2018;770;91;246;337;11,8;31,9;43,8
18;"Casimiro de Abreu";2018;721;79;96;175;11;13,3;24,3
19;"Conceição de Macabu";2018;353;38;98;136;10,8;27,8;38,5
20;"Cordeiro";2018;497;114;120;234;22,9;24,1;47,1
21;"Duas Barras";2018;312;51;81;132;16,3;26;42,3
22;"Duque de Caxias";2018;12052;3245;4586;7831;26,9;38,1;65
23;"Engenheiro Paulo de Frontin";2018;231;30;72;102;13;31,2;44,2
24;"Guapimirim";2018;750;191;130;321;25,5;17,3;42,8
25;"Iguaba Grande";2018;182;43;34;77;23,6;18,7;42,3
26;"Itaboraí";2018;2040;247;306;553;12,1;15;27,1
27;"Itaguaí";2018;2768;385;1871;2256;13,9;67,6;81,5
28;"Italva(Cardoso Moreira)";2018;451;69;146;215;15,3;32,4;47,7
29;"Itaocara";2018;433;96;131;227;22,2;30,3;52,4
30;"Itaperuna";2018;2347;137;555;692;5,8;23,6;29,5
31;"Itatiaia";2018;381;79;87;166;20,7;22,8;43,6
32;"Japeri";2018;1191;168;234;402;14,1;19,6;33,8
33;"Laje do Muriaé";2018;120;19;32;51;15,8;26,7;42,5
34;"Macaé";2018;3083;393;554;947;12,7;18;30,7
35;"Magé";2018;2134;341;715;1056;16;33,5;49,5
36;"Mangaratiba";2018;673;63;113;176;9,4;16,8;26,2
37;"Maricá";2018;1678;72;223;295;4,3;13,3;17,6
38;"Mendes";2018;210;45;44;89;21,4;21;42,4
40;"Miguel Pereira";2018;259;71;49;120;27,4;18,9;46,3
41;"Miracema";2018;410;82;105;187;20;25,6;45,6
42;"Natividade";2018;326;66;93;159;20,2;28,5;48,8
43;"Nilópolis";2018;496;2;22;24;0,4;4,4;4,8
44;"Niterói";2018;4817;1097;874;1971;22,8;18,1;40,9
45;"Nova Friburgo";2018;2045;311;562;873;15,2;27,5;42,7
46;"Nova Iguaçu";2018;12050;1788;5287;7075;14,8;43,9;58,7
47;"Paracambi";2018;647;118;85;203;18,2;13,1;31,4
48;"Paraíba do Sul";2018;438;166;70;236;37,9;16;53,9
49;"Paraty";2018;357;90;61;151;25,2;17,1;42,3
50;"Paty do Alferes";2018;226;65;40;105;28,8;17,7;46,5
51;"Petrópolis";2018;2912;1150;868;2018;39,5;29,8;69,3
52;"Pinheiral";2018;476;33;131;164;6,9;27,5;34,5
53;"Piraí";2018;315;85;60;145;27;19;46
54;"Porciúncula";2018;468;66;98;164;14,1;20,9;35
55;"Porto Real-Quatis";2018;207;42;40;82;20,3;19,3;39,6
56;"Queimados";2018;1371;230;222;452;16,8;16,2;33
57;"Resende";2018;1335;284;356;640;21,3;26,7;47,9
58;"Rio Bonito";2018;455;93;52;145;20,4;11,4;31,9
59;"Rio Claro";2018;259;47;49;96;18,1;18,9;37,1
60;"Rio Das Flores";2018;141;28;39;67;19,9;27,7;47,5
61;"Rio Das Ostras";2018;3428;348;535;883;10,2;15,6;25,8
62;"Santa Maria Madalena";2018;167;21;52;73;12,6;31,1;43,7
63;"Santo Antônio de Pádua";2018;915;145;191;336;15,8;20,9;36,7
64;"São Fidélis";2018;316;88;69;157;27,8;21,8;49,7
65;"São Francisco do Itabapoana";2018;514;45;45;90;8,8;8,8;17,5
66;"São Gonçalo";2018;6197;1476;1424;2900;23,8;23;46,8
67;"São João da Barra";2018;439;129;30;159;29,4;6,8;36,2
68;"São João de Meriti";2018;69;2;7;9;2,9;10,1;13
69;"São José do Vale do Rio Preto";2018;282;26;34;60;9,2;12,1;21,3
70;"São Pedro da Aldeia";2018;793;149;199;348;18,8;25,1;43,9
71;"São Sebastião do Alto";2018;1005;18;742;760;1,8;73,8;75,6
72;"Sapucaia";2018;239;50;50;100;20,9;20,9;41,8
73;"Saquarema";2018;109;2;3;5;1,8;2,8;4,6
74;"Seropédica";2018;691;130;85;215;18,8;12,3;31,1
75;"Silva Jardim";2018;117;29;22;51;24,8;18,8;43,6
76;"Sumidouro";2018;133;51;32;83;38,3;24,1;62,4
78;"Teresópolis";2018;2064;455;505;960;22;24,5;46,5
79;"Trajano de Moraes";2018;124;18;52;70;14,5;41,9;56,5
80;"Três Rios";2018;1718;611;282;893;35,6;16,4;52
81;"Valença";2018;1297;200;380;580;15,4;29,3;44,7
82;"Vassouras";2018;901;49;184;233;5,4;20,4;25,9
83;"Volta Redonda";2018;3591;360;392;752;10;10,9;20,9
1;"Angra dos Reis";2017;2061;210;363;573;10,2;17,6;27,8
2;"Araruama";2017;2874;405;656;1061;14,1;22,8;36,9
3;"Armação dos Búzios";2017;585;110;131;241;18,8;22,4;41,2
4;"Arraial do Cabo";2017;556;67;197;264;12,1;35,4;47,5
5;"Barra do Piraí";2017;1221;218;363;581;17,9;29,7;47,6
6;"Barra Mansa";2017;1801;296;323;619;16,4;17,9;34,4
7;"Belford Roxo";2017;2460;1;17;18;0;0,7;0,7
8;"Bom Jardim";2017;250;48;50;98;19,2;20;39,2
9;"Bom Jesus do Itabapoana";2017;534;97;116;213;18,2;21,7;39,9
10;"Cabo Frio";2017;3214;259;949;1208;8,1;29,5;37,6
11;"Cachoeiras de Macacu";2017;717;101;161;262;14,1;22,5;36,5
12;"Cambuci";2017;198;15;63;78;7,6;31,8;39,4
13;"Campos dos Goytacazes";2017;2708;304;207;511;11,2;7,6;18,9
14;"Cantagalo";2017;302;62;121;183;20,5;40,1;60,6
15;"Rio de Janeiro";2017;51536;10756;12350;23106;20,9;24;44,8
16;"Carapebus/Quissamã";2017;571;71;109;180;12,4;19,1;31,5
17;"Carmo";2017;563;65;78;143;11,5;13,9;25,4
18;"Casimiro de Abreu";2017;501;52;74;126;10,4;14,8;25,1
19;"Conceição de Macabu";2017;247;28;64;92;11,3;25,9;37,2
20;"Cordeiro";2017;358;86;91;177;24;25,4;49,4
21;"Duas Barras";2017;218;19;61;80;8,7;28;36,7
22;"Duque de Caxias";2017;11820;2376;6984;9360;20,1;59,1;79,2
23;"Engenheiro Paulo de Frontin";2017;256;18;90;108;7;35,2;42,2
24;"Guapimirim";2017;823;187;213;400;22,7;25,9;48,6
25;"Iguaba Grande";2017;280;68;54;122;24,3;19,3;43,6
26;"Itaboraí";2017;2126;167;552;719;7,9;26;33,8
27;"Itaguaí";2017;2442;276;1063;1339;11,3;43,5;54,8
28;"Italva(Cardoso Moreira)";2017;369;73;114;187;19,8;30,9;50,7
29;"Itaocara";2017;366;97;120;217;26,5;32,8;59,3
30;"Itaperuna";2017;2697;235;887;1122;8,7;32,9;41,6
31;"Itatiaia";2017;244;65;60;125;26,6;24,6;51,2
32;"Japeri";2017;1405;141;417;558;10;29,7;39,7
33;"Laje do Muriaé";2017;147;31;49;80;21,1;33,3;54,4
34;"Macaé";2017;2637;323;736;1059;12,2;27,9;40,2
35;"Magé";2017;2098;350;740;1090;16,7;35,3;52
36;"Mangaratiba";2017;927;49;152;201;5,3;16,4;21,7
37;"Maricá";2017;2749;131;563;694;4,8;20,5;25,2
38;"Mendes";2017;287;42;86;128;14,6;30;44,6
40;"Miguel Pereira";2017;321;90;67;157;28;20,9;48,9
41;"Miracema";2017;271;54;75;129;19,9;27,7;47,6
42;"Natividade";2017;346;71;123;194;20,5;35,5;56,1
43;"Nilópolis";2017;573;3;53;56;0,5;9,2;9,8
44;"Niterói";2017;4784;778;1082;1860;16,3;22,6;38,9
45;"Nova Friburgo";2017;3420;331;873;1204;9,7;25,5;35,2
46;"Nova Iguaçu";2017;10720;1342;5599;6941;12,5;52,2;64,7
47;"Paracambi";2017;596;128;117;245;21,5;19,6;41,1
48;"Paraíba do Sul";2017;393;121;61;182;30,8;15,5;46,3
49;"Paraty";2017;267;66;60;126;24,7;22,5;47,2
50;"Paty do Alferes";2017;199;44;24;68;22,1;12,1;34,2
51;"Petrópolis";2017;2404;908;738;1646;37,8;30,7;68,5
52;"Pinheiral";2017;275;21;97;118;7,6;35,3;42,9
53;"Piraí";2017;271;73;71;144;26,9;26,2;53,1
54;"Porciúncula";2017;429;71;117;188;16,6;27,3;43,8
55;"Porto Real-Quatis";2017;222;38;57;95;17,1;25,7;42,8
56;"Queimados";2017;840;136;224;360;16,2;26,7;42,9
57;"Resende";2017;1782;411;366;777;23,1;20,5;43,6
58;"Rio Bonito";2017;461;77;59;136;16,7;12,8;29,5
59;"Rio Claro";2017;371;38;74;112;10,2;19,9;30,2
60;"Rio Das Flores";2017;119;28;42;70;23,5;35,3;58,8
61;"Rio Das Ostras";2017;1968;250;625;875;12,7;31,8;44,5
62;"Santa Maria Madalena";2017;107;22;36;58;20,6;33,6;54,2
63;"Santo Antônio de Pádua";2017;661;57;136;193;8,6;20,6;29,2
64;"São Fidélis";2017;339;69;101;170;20,4;29,8;50,1
65;"São Francisco do Itabapoana";2017;466;81;83;164;17,4;17,8;35,2
66;"São Gonçalo";2017;4558;856;1432;2288;18,8;31,4;50,2
67;"São João da Barra";2017;491;74;45;119;15,1;9,2;24,2
68;"São João de Meriti";2017;328;2;6;8;0,6;1,8;2,4
69;"São José do Vale do Rio Preto";2017;200;24;27;51;12;13,5;25,5
70;"São Pedro da Aldeia";2017;638;111;238;349;17,4;37,3;54,7
71;"São Sebastião do Alto";2017;115;26;42;68;22,6;36,5;59,1
72;"Sapucaia";2017;288;57;47;104;19,8;16,3;36,1
73;"Saquarema";2017;63;1;2;3;1,6;3,2;4,8
74;"Seropédica";2017;795;118;186;304;14,8;23,4;38,2
75;"Silva Jardim";2017;137;39;35;74;28,5;25,5;54
76;"Sumidouro";2017;117;38;32;70;32,5;27,4;59,8
78;"Teresópolis";2017;1908;441;453;894;23,1;23,7;46,9
79;"Trajano de Moraes";2017;148;26;72;98;17,6;48,6;66,2
80;"Três Rios";2017;1630;475;361;836;29,1;22,1;51,3
81;"Valença";2017;1103;146;410;556;13,2;37,2;50,4
82;"Vassouras";2017;970;81;283;364;8,4;29,2;37,5
83;"Volta Redonda";2017;3010;301;332;633;10;11;21
1;"Angra dos Reis";2016;1493;367;457;824;24,6;30,6;55,2
2;"Araruama";2016;3130;340;1007;1347;10,9;32,2;43
3;"Armação dos Búzios";2016;704;209;117;326;29,7;16,6;46,3
4;"Arraial do Cabo";2016;475;70;85;155;14,7;17,9;32,6
5;"Barra do Piraí";2016;1228;155;432;587;12,6;35,2;47,8
6;"Barra Mansa";2016;1338;233;389;622;17,4;29,1;46,5
7;"Belford Roxo";2016;2050;5;17;22;0,2;0,8;1,1
8;"Bom Jardim";2016;249;49;72;121;19,7;28,9;48,6
9;"Bom Jesus do Itabapoana";2016;409;67;123;190;16,4;30,1;46,5
10;"Cabo Frio";2016;5212;450;2238;2688;8,6;42,9;51,6
11;"Cachoeiras de Macacu";2016;709;92;204;296;13;28,8;41,7
12;"Cambuci";2016;174;19;55;74;10,9;31,6;42,5
13;"Campos dos Goytacazes";2016;2329;243;204;447;10,4;8,8;19,2
14;"Cantagalo";2016;224;54;65;119;24,1;29;53,1
15;"Rio de Janeiro";2016;57094;10708;17602;28310;18,8;30,8;49,6
16;"Carapebus/Quissamã";2016;716;90;186;276;12,6;26;38,5
17;"Carmo";2016;385;60;75;135;15,6;19,5;35,1
18;"Casimiro de Abreu";2016;393;45;78;123;11,5;19,8;31,3
19;"Conceição de Macabu";2016;238;22;63;85;9,2;26,5;35,7
20;"Cordeiro";2016;359;77;84;161;21,4;23,4;44,8
21;"Duas Barras";2016;256;18;56;74;7;21,9;28,9
22;"Duque de Caxias";2016;15641;2833;9455;12288;18,1;60,5;78,6
23;"Engenheiro Paulo de Frontin";2016;187;39;46;85;20,9;24,6;45,5
24;"Guapimirim";2016;1219;158;264;422;13;21,7;34,6
25;"Iguaba Grande";2016;450;93;62;155;20,7;13,8;34,4
26;"Itaboraí";2016;3160;238;1004;1242;7,5;31,8;39,3
27;"Itaguaí";2016;1519;386;364;750;25,4;24;49,4
28;"Italva(Cardoso Moreira)";2016;383;66;115;181;17,2;30;47,3
29;"Itaocara";2016;246;60;84;144;24,4;34,1;58,5
30;"Itaperuna";2016;1461;202;590;792;13,8;40,4;54,2
31;"Itatiaia";2016;302;68;63;131;22,5;20,9;43,4
32;"Japeri";2016;478;49;139;188;10,3;29,1;39,3
33;"Laje do Muriaé";2016;97;20;27;47;20,6;27,8;48,5
34;"Macaé";2016;2555;243;537;780;9,5;21;30,5
35;"Magé";2016;2451;312;488;800;12,7;19,9;32,6
36;"Mangaratiba";2016;726;61;83;144;8,4;11,4;19,8
37;"Maricá";2016;1822;151;428;579;8,3;23,5;31,8
38;"Mendes";2016;362;44;154;198;12,2;42,5;54,7
40;"Miguel Pereira";2016;376;91;83;174;24,2;22,1;46,3
41;"Miracema";2016;305;88;69;157;28,9;22,6;51,5
42;"Natividade";2016;324;87;113;200;26,9;34,9;61,7
43;"Nilópolis";2016;983;1;36;37;0,1;3,7;3,8
44;"Niterói";2016;6652;754;1504;2258;11,3;22,6;33,9
45;"Nova Friburgo";2016;2446;292;863;1155;11,9;35,3;47,2
46;"Nova Iguaçu";2016;12107;1668;7810;9478;13,8;64,5;78,3
47;"Paracambi";2016;716;130;198;328;18,2;27,7;45,8
48;"Paraíba do Sul";2016;302;100;44;144;33,1;14,6;47,7
49;"Paraty";2016;294;53;84;137;18;28,6;46,6
50;"Paty do Alferes";2016;202;54;52;106;26,7;25,7;52,5
51;"Petrópolis";2016;2698;842;780;1622;31,2;28,9;60,1
52;"Pinheiral";2016;440;23;125;148;5,2;28,4;33,6
53;"Piraí";2016;330;109;79;188;33;23,9;57
54;"Porciúncula";2016;413;93;107;200;22,5;25,9;48,4
55;"Porto Real-Quatis";2016;245;49;54;103;20;22;42
56;"Queimados";2016;1977;109;287;396;5,5;14,5;20
57;"Resende";2016;1947;393;574;967;20,2;29,5;49,7
58;"Rio Bonito";2016;590;87;98;185;14,7;16,6;31,4
59;"Rio Claro";2016;307;35;32;67;11,4;10,4;21,8
60;"Rio Das Flores";2016;100;22;31;53;22;31;53
61;"Rio Das Ostras";2016;2039;290;725;1015;14,2;35,6;49,8
62;"Santa Maria Madalena";2016;98;19;41;60;19,4;41,8;61,2
63;"Santo Antônio de Pádua";2016;610;76;150;226;12,5;24,6;37
64;"São Fidélis";2016;420;80;97;177;19;23,1;42,1
65;"São Francisco do Itabapoana";2016;556;52;98;150;9,4;17,6;27
66;"São Gonçalo";2016;7320;1399;2694;4093;19,1;36,8;55,9
67;"São João da Barra";2016;604;116;129;245;19,2;21,4;40,6
68;"São João de Meriti";2016;2684;6;56;62;0,2;2,1;2,3
69;"São José do Vale do Rio Preto";2016;136;15;26;41;11;19,1;30,1
70;"São Pedro da Aldeia";2016;706;84;282;366;11,9;39,9;51,8
71;"São Sebastião do Alto";2016;23;2;5;7;8,7;21,7;30,4
72;"Sapucaia";2016;259;43;43;86;16,6;16,6;33,2
73;"Saquarema";2016;14;2;0;2;14,3;0;14,3
74;"Seropédica";2016;648;81;150;231;12,5;23,1;35,6
75;"Silva Jardim";2016;133;47;32;79;35,3;24,1;59,4
76;"Sumidouro";2016;137;40;42;82;29,2;30,7;59,9
78;"Teresópolis";2016;3137;706;867;1573;22,5;27,6;50,1
79;"Trajano de Moraes";2016;213;20;99;119;9,4;46,5;55,9
80;"Três Rios";2016;1389;453;282;735;32,6;20,3;52,9
81;"Valença";2016;879;160;208;368;18,2;23,7;41,9
82;"Vassouras";2016;1081;113;402;515;10,5;37,2;47,6
83;"Volta Redonda";2016;2040;342;466;808;16,8;22,8;39,6
1;"Angra dos Reis";2015;2843;335;985;1320;11,8;34,6;46,4
2;"Araruama";2015;4064;246;1674;1920;6,1;41,2;47,2
3;"Armação dos Búzios";2015;951;149;198;347;15,7;20,8;36,5
4;"Arraial do Cabo";2015;544;64;151;215;11,8;27,8;39,5
5;"Barra do Piraí";2015;1185;160;383;543;13,5;32,3;45,8
6;"Barra Mansa";2015;1729;285;490;775;16,5;28,3;44,8
7;"Belford Roxo";2015;1763;9;26;35;0,5;1,5;2
8;"Bom Jardim";2015;205;42;72;114;20,5;35,1;55,6
9;"Bom Jesus do Itabapoana";2015;561;130;209;339;23,2;37,3;60,4
10;"Cabo Frio";2015;3312;471;1241;1712;14,2;37,5;51,7
11;"Cachoeiras de Macacu";2015;597;78;118;196;13,1;19,8;32,8
12;"Cambuci";2015;232;33;68;101;14,2;29,3;43,5
13;"Campos dos Goytacazes";2015;3907;622;407;1029;15,9;10,4;26,3
14;"Cantagalo";2015;190;48;45;93;25,3;23,7;48,9
15;"Rio de Janeiro";2015;63562;11750;20262;32012;18,5;31,9;50,4
16;"Carapebus/Quissamã";2015;946;98;271;369;10,4;28,6;39
17;"Carmo";2015;220;52;52;104;23,6;23,6;47,3
18;"Casimiro de Abreu";2015;568;98;149;247;17,3;26,2;43,5
19;"Conceição de Macabu";2015;318;27;130;157;8,5;40,9;49,4
20;"Cordeiro";2015;381;96;136;232;25,2;35,7;60,9
21;"Duas Barras";2015;336;33;86;119;9,8;25,6;35,4
22;"Duque de Caxias";2015;11476;2527;6859;9386;22;59,8;81,8
23;"Engenheiro Paulo de Frontin";2015;259;38;99;137;14,7;38,2;52,9
24;"Guapimirim";2015;787;64;187;251;8,1;23,8;31,9
25;"Iguaba Grande";2015;349;83;69;152;23,8;19,8;43,6
26;"Itaboraí";2015;2576;242;907;1149;9,4;35,2;44,6
27;"Itaguaí";2015;1545;293;368;661;19;23,8;42,8
28;"Italva(Cardoso Moreira)";2015;370;89;113;202;24,1;30,5;54,6
29;"Itaocara";2015;316;79;104;183;25;32,9;57,9
30;"Itaperuna";2015;1023;192;277;469;18,8;27,1;45,8
31;"Itatiaia";2015;348;78;85;163;22,4;24,4;46,8
32;"Japeri";2015;661;52;275;327;7,9;41,6;49,5
33;"Laje do Muriaé";2015;92;21;19;40;22,8;20,7;43,5
34;"Macaé";2015;2058;249;578;827;12,1;28,1;40,2
35;"Magé";2015;2952;313;533;846;10,6;18,1;28,7
36;"Mangaratiba";2015;863;138;157;295;16;18,2;34,2
37;"Maricá";2015;2609;219;695;914;8,4;26,6;35
38;"Mendes";2015;209;48;51;99;23;24,4;47,4
40;"Miguel Pereira";2015;298;97;72;169;32,6;24,2;56,7
41;"Miracema";2015;378;80;91;171;21,2;24,1;45,2
42;"Natividade";2015;278;100;73;173;36;26,3;62,2
43;"Nilópolis";2015;185;13;20;33;7;10,8;17,8
44;"Niterói";2015;5790;838;1906;2744;14,5;32,9;47,4
45;"Nova Friburgo";2015;3031;360;924;1284;11,9;30,5;42,4
46;"Nova Iguaçu";2015;13240;1645;7098;8743;12,4;53,6;66
47;"Paracambi";2015;727;161;176;337;22,1;24,2;46,4
48;"Paraíba do Sul";2015;378;135;72;207;35,7;19;54,8
49;"Paraty";2015;329;41;131;172;12,5;39,8;52,3
50;"Paty do Alferes";2015;222;63;37;100;28,4;16,7;45
51;"Petrópolis";2015;2883;949;778;1727;32,9;27;59,9
52;"Pinheiral";2015;460;60;155;215;13;33,7;46,7
53;"Piraí";2015;476;127;123;250;26,7;25,8;52,5
54;"Porciúncula";2015;439;105;106;211;23,9;24,1;48,1
55;"Porto Real-Quatis";2015;269;49;76;125;18,2;28,3;46,5
56;"Queimados";2015;1132;170;231;401;15;20,4;35,4
57;"Resende";2015;2249;315;634;949;14;28,2;42,2
58;"Rio Bonito";2015;627;123;129;252;19,6;20,6;40,2
59;"Rio Claro";2015;315;43;34;77;13,7;10,8;24,4
60;"Rio Das Flores";2015;122;20;48;68;16,4;39,3;55,7
61;"Rio Das Ostras";2015;2174;408;858;1266;18,8;39,5;58,2
62;"Santa Maria Madalena";2015;137;38;42;80;27,7;30,7;58,4
63;"Santo Antônio de Pádua";2015;767;87;252;339;11,3;32,9;44,2
64;"São Fidélis";2015;596;111;159;270;18,6;26,7;45,3
65;"São Francisco do Itabapoana";2015;729;71;158;229;9,7;21,7;31,4
66;"São Gonçalo";2015;7276;1120;2800;3920;15,4;38,5;53,9
67;"São João da Barra";2015;645;130;122;252;20,2;18,9;39,1
68;"São João de Meriti";2015;2317;4;42;46;0,2;1,8;2
69;"São José do Vale do Rio Preto";2015;238;30;56;86;12,6;23,5;36,1
70;"São Pedro da Aldeia";2015;1018;113;441;554;11,1;43,3;54,4
71;"São Sebastião do Alto";2015;72;9;25;34;12,5;34,7;47,2
72;"Sapucaia";2015;192;27;48;75;14,1;25;39,1
73;"Saquarema";2015;9;0;1;1;0;11,1;11,1
74;"Seropédica";2015;737;83;269;352;11,3;36,5;47,8
75;"Silva Jardim";2015;181;42;67;109;23,2;37;60,2
76;"Sumidouro";2015;119;31;44;75;26,1;37;63
78;"Teresópolis";2015;2927;512;682;1194;17,5;23,3;40,8
79;"Trajano de Moraes";2015;227;36;92;128;15,9;40,5;56,4
80;"Três Rios";2015;1562;499;361;860;31,9;23,1;55,1
81;"Valença";2015;1014;198;283;481;19,5;27,9;47,4
82;"Vassouras";2015;727;95;169;264;13,1;23,2;36,3
83;"Volta Redonda";2015;1570;346;389;735;22;24,8;46,8
1;"Angra dos Reis";2014;2250;259;997;1256;11,5;44,3;55,8
2;"Araruama";2014;3492;224;1301;1525;6,4;37,3;43,7
3;"Armação dos Búzios";2014;1011;131;499;630;13;49,4;62,3
4;"Arraial do Cabo";2014;641;77;200;277;12;31,2;43,2
5;"Barra do Piraí";2014;966;197;399;596;20,4;41,3;61,7
6;"Barra Mansa";2014;1562;292;501;793;18,7;32,1;50,8
7;"Belford Roxo";2014;683;4;27;31;0,6;4;4,5
8;"Bom Jardim";2014;546;83;132;215;15,2;24,2;39,4
9;"Bom Jesus do Itabapoana";2014;479;102;114;216;21,3;23,8;45,1
10;"Cabo Frio";2014;3605;558;1176;1734;15,5;32,6;48,1
11;"Cachoeiras de Macacu";2014;731;118;187;305;16,1;25,6;41,7
12;"Cambuci";2014;195;28;71;99;14,4;36,4;50,8
13;"Campos dos Goytacazes";2014;5562;1066;868;1934;19,2;15,6;34,8
14;"Cantagalo";2014;406;76;121;197;18,7;29,8;48,5
15;"Rio de Janeiro";2014;80661;14086;28221;42307;17,5;35;52,5
16;"Carapebus/Quissamã";2014;468;55;152;207;11,8;32,5;44,2
17;"Carmo";2014;352;67;67;134;19;19;38,1
18;"Casimiro de Abreu";2014;855;87;297;384;10,2;34,7;44,9
19;"Conceição de Macabu";2014;252;29;91;120;11,5;36,1;47,6
20;"Cordeiro";2014;379;91;111;202;24;29,3;53,3
21;"Duas Barras";2014;361;11;123;134;3;34,1;37,1
22;"Duque de Caxias";2014;16862;3273;10818;14091;19,4;64,2;83,6
23;"Engenheiro Paulo de Frontin";2014;235;36;61;97;15,3;26;41,3
24;"Guapimirim";2014;1014;84;204;288;8,3;20,1;28,4
25;"Iguaba Grande";2014;323;85;62;147;26,3;19,2;45,5
26;"Itaboraí";2014;3905;334;1611;1945;8,6;41,3;49,8
27;"Itaguaí";2014;1956;444;637;1081;22,7;32,6;55,3
28;"Italva(Cardoso Moreira)";2014;380;86;130;216;22,6;34,2;56,8
29;"Itaocara";2014;436;120;153;273;27,5;35,1;62,6
30;"Itaperuna";2014;1339;204;380;584;15,2;28,4;43,6
31;"Itatiaia";2014;342;97;75;172;28,4;21,9;50,3
32;"Japeri";2014;1209;94;517;611;7,8;42,8;50,5
33;"Laje do Muriaé";2014;95;28;27;55;29,5;28,4;57,9
34;"Macaé";2014;3350;382;1269;1651;11,4;37,9;49,3
35;"Magé";2014;3011;274;626;900;9,1;20,8;29,9
36;"Mangaratiba";2014;682;125;153;278;18,3;22,4;40,8
37;"Maricá";2014;2401;276;631;907;11,5;26,3;37,8
38;"Mendes";2014;185;19;25;44;10,3;13,5;23,8
40;"Miguel Pereira";2014;440;120;102;222;27,3;23,2;50,5
41;"Miracema";2014;462;94;136;230;20,3;29,4;49,8
42;"Natividade";2014;301;117;86;203;38,9;28,6;67,4
43;"Nilópolis";2014;244;6;55;61;2,5;22,5;25
44;"Niterói";2014;6565;1315;2410;3725;20;36,7;56,7
45;"Nova Friburgo";2014;4488;605;1632;2237;13,5;36,4;49,8
46;"Nova Iguaçu";2014;12842;1600;8541;10141;12,5;66,5;79
47;"Paracambi";2014;775;165;234;399;21,3;30,2;51,5
48;"Paraíba do Sul";2014;800;225;152;377;28,1;19;47,1
49;"Paraty";2014;653;83;179;262;12,7;27,4;40,1
50;"Paty do Alferes";2014;231;59;44;103;25,5;19;44,6
51;"Petrópolis";2014;2454;886;801;1687;36,1;32,6;68,7
52;"Pinheiral";2014;418;60;157;217;14,4;37,6;51,9
53;"Piraí";2014;294;60;127;187;20,4;43,2;63,6
54;"Porciúncula";2014;488;109;120;229;22,3;24,6;46,9
55;"Porto Real-Quatis";2014;361;72;127;199;19,9;35,2;55,1
56;"Queimados";2014;1208;192;416;608;15,9;34,4;50,3
57;"Resende";2014;2060;375;711;1086;18,2;34,5;52,7
58;"Rio Bonito";2014;609;113;144;257;18,6;23,6;42,2
59;"Rio Claro";2014;368;44;31;75;12;8,4;20,4
60;"Rio Das Flores";2014;140;21;59;80;15;42,1;57,1
61;"Rio Das Ostras";2014;1800;426;681;1107;23,7;37,8;61,5
62;"Santa Maria Madalena";2014;176;33;66;99;18,8;37,5;56,2
63;"Santo Antônio de Pádua";2014;927;134;384;518;14,5;41,4;55,9
64;"São Fidélis";2014;554;122;182;304;22;32,9;54,9
65;"São Francisco do Itabapoana";2014;665;86;177;263;12,9;26,6;39,5
66;"São Gonçalo";2014;9215;1250;4377;5627;13,6;47,5;61,1
67;"São João da Barra";2014;953;223;206;429;23,4;21,6;45
68;"São João de Meriti";2014;205;2;36;38;1;17,6;18,5
69;"São José do Vale do Rio Preto";2014;425;28;72;100;6,6;16,9;23,5
70;"São Pedro da Aldeia";2014;1352;169;534;703;12,5;39,5;52
71;"São Sebastião do Alto";2014;107;8;39;47;7,5;36,4;43,9
72;"Sapucaia";2014;477;51;182;233;10,7;38,2;48,8
73;"Saquarema";2014;89;8;6;14;9;6,7;15,7
74;"Seropédica";2014;1015;49;278;327;4,8;27,4;32,2
75;"Silva Jardim";2014;174;29;47;76;16,7;27;43,7
76;"Sumidouro";2014;178;52;42;94;29,2;23,6;52,8
78;"Teresópolis";2014;2565;555;722;1277;21,6;28,1;49,8
79;"Trajano de Moraes";2014;185;21;95;116;11,4;51,4;62,7
80;"Três Rios";2014;1485;363;332;695;24,4;22,4;46,8
81;"Valença";2014;1501;253;473;726;16,9;31,5;48,4
82;"Vassouras";2014;716;117;128;245;16,3;17,9;34,2
83;"Volta Redonda";2014;2052;559;582;1141;27,2;28,4;55,6
1;"Angra dos Reis";2013;2338;300;1174;1474;12,8;50,2;63
2;"Araruama";2013;2172;133;756;889;6,1;34,8;40,9
3;"Armação dos Búzios";2013;657;125;193;318;19;29,4;48,4
4;"Arraial do Cabo";2013;646;90;227;317;13,9;35,1;49,1
5;"Barra do Piraí";2013;964;156;281;437;16,2;29,1;45,3
6;"Barra Mansa";2013;1911;430;603;1033;22,5;31,6;54,1
7;"Belford Roxo";2013;473;8;20;28;1,7;4,2;5,9
8;"Bom Jardim";2013;590;56;216;272;9,5;36,6;46,1
9;"Bom Jesus do Itabapoana";2013;482;90;100;190;18,7;20,7;39,4
10;"Cabo Frio";2013;4212;742;2335;3077;17,6;55,4;73,1
11;"Cachoeiras de Macacu";2013;1025;141;389;530;13,8;38;51,7
12;"Cambuci";2013;177;24;60;84;13,6;33,9;47,5
13;"Campos dos Goytacazes";2013;5146;586;1016;1602;11,4;19,7;31,1
14;"Cantagalo";2013;637;99;326;425;15,5;51,2;66,7
15;"Rio de Janeiro";2013;80720;13574;31259;44833;16,8;38,7;55,5
16;"Carapebus/Quissamã";2013;889;60;367;427;6,7;41,3;48
17;"Carmo";2013;276;80;60;140;29;21,7;50,7
18;"Casimiro de Abreu";2013;475;85;117;202;17,9;24,6;42,5
19;"Conceição de Macabu";2013;298;43;116;159;14,4;38,9;53,4
20;"Cordeiro";2013;549;119;239;358;21,7;43,5;65,2
21;"Duas Barras";2013;370;32;100;132;8,6;27;35,7
22;"Duque de Caxias";2013;18505;2539;12985;15524;13,7;70,2;83,9
23;"Engenheiro Paulo de Frontin";2013;262;27;152;179;10,3;58;68,3
24;"Guapimirim";2013;1503;93;292;385;6,2;19,4;25,6
25;"Iguaba Grande";2013;312;70;54;124;22,4;17,3;39,7
26;"Itaboraí";2013;3222;288;1277;1565;8,9;39,6;48,6
27;"Itaguaí";2013;1284;312;550;862;24,3;42,8;67,1
28;"Italva(Cardoso Moreira)";2013;441;92;155;247;20,9;35,1;56
29;"Itaocara";2013;266;45;59;104;16,9;22,2;39,1
30;"Itaperuna";2013;982;123;352;475;12,5;35,8;48,4
31;"Itatiaia";2013;436;94;123;217;21,6;28,2;49,8
32;"Japeri";2013;1318;102;551;653;7,7;41,8;49,5
33;"Laje do Muriaé";2013;89;18;13;31;20,2;14,6;34,8
34;"Macaé";2013;3251;297;1210;1507;9,1;37,2;46,4
35;"Magé";2013;3161;189;590;779;6;18,7;24,6
36;"Mangaratiba";2013;606;86;160;246;14,2;26,4;40,6
37;"Maricá";2013;1386;137;407;544;9,9;29,4;39,2
38;"Mendes";2013;120;11;16;27;9,2;13,3;22,5
40;"Miguel Pereira";2013;213;72;65;137;33,8;30,5;64,3
41;"Miracema";2013;436;74;114;188;17;26,1;43,1
42;"Natividade";2013;266;107;63;170;40,2;23,7;63,9
43;"Nilópolis";2013;209;3;30;33;1,4;14,4;15,8
44;"Niterói";2013;6629;1186;2169;3355;17,9;32,7;50,6
45;"Nova Friburgo";2013;3946;512;1731;2243;13;43,9;56,8
46;"Nova Iguaçu";2013;13919;1985;9652;11637;14,3;69,3;83,6
47;"Paracambi";2013;578;132;148;280;22,8;25,6;48,4
48;"Paraíba do Sul";2013;689;150;137;287;21,8;19,9;41,7
49;"Paraty";2013;456;112;94;206;24,6;20,6;45,2
50;"Paty do Alferes";2013;160;58;44;102;36,2;27,5;63,8
51;"Petrópolis";2013;3018;1009;1027;2036;33,4;34;67,5
52;"Pinheiral";2013;226;9;56;65;4;24,8;28,8
53;"Piraí";2013;407;124;140;264;30,5;34,4;64,9
54;"Porciúncula";2013;374;101;94;195;27;25,1;52,1
55;"Porto Real-Quatis";2013;344;84;70;154;24,4;20,3;44,8
56;"Queimados";2013;824;98;335;433;11,9;40,7;52,5
57;"Resende";2013;1127;180;381;561;16;33,8;49,8
58;"Rio Bonito";2013;522;96;109;205;18,4;20,9;39,3
59;"Rio Claro";2013;478;58;96;154;12,1;20,1;32,2
60;"Rio Das Flores";2013;172;22;68;90;12,8;39,5;52,3
61;"Rio Das Ostras";2013;1577;363;717;1080;23;45,5;68,5
62;"Santa Maria Madalena";2013;209;30;65;95;14,4;31,1;45,5
63;"Santo Antônio de Pádua";2013;871;124;369;493;14,2;42,4;56,6
64;"São Fidélis";2013;546;151;117;268;27,7;21,4;49,1
65;"São Francisco do Itabapoana";2013;1085;93;278;371;8,6;25,6;34,2
66;"São Gonçalo";2013;9313;956;4880;5836;10,3;52,4;62,7
67;"São João da Barra";2013;2064;240;622;862;11,6;30,1;41,8
68;"São João de Meriti";2013;155;2;21;23;1,3;13,5;14,8
69;"São José do Vale do Rio Preto";2013;255;25;42;67;9,8;16,5;26,3
70;"São Pedro da Aldeia";2013;776;119;211;330;15,3;27,2;42,5
71;"São Sebastião do Alto";2013;122;14;29;43;11,5;23,8;35,2
72;"Sapucaia";2013;347;65;103;168;18,7;29,7;48,4
73;"Saquarema";2013;412;39;136;175;9,5;33;42,5
74;"Seropédica";2013;813;55;242;297;6,8;29,8;36,5
75;"Silva Jardim";2013;269;33;66;99;12,3;24,5;36,8
76;"Sumidouro";2013;144;33;44;77;22,9;30,6;53,5
78;"Teresópolis";2013;2862;433;891;1324;15,1;31,1;46,3
79;"Trajano de Moraes";2013;191;23;86;109;12;45;57,1
80;"Três Rios";2013;1537;454;345;799;29,5;22,4;52
81;"Valença";2013;1580;242;604;846;15,3;38,2;53,5
82;"Vassouras";2013;931;100;144;244;10,7;15,5;26,2
83;"Volta Redonda";2013;2372;660;815;1475;27,8;34,4;62,2
1;"Angra dos Reis";2012;2489;211;1277;1488;8,5;51,3;59,8
2;"Araruama";2012;3023;118;1440;1558;3,9;47,6;51,5
3;"Armação dos Búzios";2012;485;73;125;198;15,1;25,8;40,8
4;"Arraial do Cabo";2012;595;80;246;326;13,4;41,3;54,8
5;"Barra do Piraí";2012;968;70;344;414;7,2;35,5;42,8
6;"Barra Mansa";2012;1632;452;563;1015;27,7;34,5;62,2
7;"Belford Roxo";2012;904;3;66;69;0,3;7,3;7,6
8;"Bom Jardim";2012;556;48;133;181;8,6;23,9;32,6
9;"Bom Jesus do Itabapoana";2012;350;54;49;103;15,4;14;29,4
10;"Cabo Frio";2012;4069;495;2448;2943;12,2;60,2;72,3
11;"Cachoeiras de Macacu";2012;1167;155;298;453;13,3;25,5;38,8
12;"Cambuci";2012;246;32;92;124;13;37,4;50,4
13;"Campos dos Goytacazes";2012;5720;527;1125;1652;9,2;19,7;28,9
14;"Cantagalo";2012;446;76;138;214;17;30,9;48
15;"Rio de Janeiro";2012;76997;13237;35041;48278;17,2;45,5;62,7
16;"Carapebus/Quissamã";2012;792;63;351;414;8;44,3;52,3
17;"Carmo";2012;320;76;97;173;23,8;30,3;54,1
18;"Casimiro de Abreu";2012;598;106;179;285;17,7;29,9;47,7
19;"Conceição de Macabu";2012;300;28;113;141;9,3;37,7;47
20;"Cordeiro";2012;476;94;138;232;19,7;29;48,7
21;"Duas Barras";2012;353;30;109;139;8,5;30,9;39,4
22;"Duque de Caxias";2012;18142;1857;12722;14579;10,2;70,1;80,4
23;"Engenheiro Paulo de Frontin";2012;192;34;72;106;17,7;37,5;55,2
24;"Guapimirim";2012;1435;54;300;354;3,8;20,9;24,7
25;"Iguaba Grande";2012;257;55;66;121;21,4;25,7;47,1
26;"Itaboraí";2012;6048;456;2012;2468;7,5;33,3;40,8
27;"Itaguaí";2012;1776;285;1070;1355;16;60,2;76,3
28;"Italva(Cardoso Moreira)";2012;367;83;131;214;22,6;35,7;58,3
29;"Itaocara";2012;217;51;58;109;23,5;26,7;50,2
30;"Itaperuna";2012;903;97;313;410;10,7;34,7;45,4
31;"Itatiaia";2012;334;75;95;170;22,5;28,4;50,9
32;"Japeri";2012;2028;167;643;810;8,2;31,7;39,9
33;"Laje do Muriaé";2012;86;23;24;47;26,7;27,9;54,7
34;"Macaé";2012;2969;348;1248;1596;11,7;42;53,8
35;"Magé";2012;2715;203;541;744;7,5;19,9;27,4
36;"Mangaratiba";2012;952;112;437;549;11,8;45,9;57,7
37;"Maricá";2012;1832;203;675;878;11,1;36,8;47,9
38;"Mendes";2012;101;6;25;31;5,9;24,8;30,7
40;"Miguel Pereira";2012;229;52;93;145;22,7;40,6;63,3
41;"Miracema";2012;470;116;118;234;24,7;25,1;49,8
42;"Natividade";2012;249;96;65;161;38,6;26,1;64,7
43;"Nilópolis";2012;203;2;35;37;1;17,2;18,2
44;"Niterói";2012;6511;1338;2344;3682;20,5;36;56,6
45;"Nova Friburgo";2012;2635;467;1054;1521;17,7;40;57,7
46;"Nova Iguaçu";2012;12530;1968;8581;10549;15,7;68,5;84,2
47;"Paracambi";2012;621;107;158;265;17,2;25,4;42,7
48;"Paraíba do Sul";2012;662;163;166;329;24,6;25,1;49,7
49;"Paraty";2012;480;150;72;222;31,2;15;46,2
50;"Paty do Alferes";2012;150;48;56;104;32;37,3;69,3
51;"Petrópolis";2012;3438;1366;1004;2370;39,7;29,2;68,9
52;"Pinheiral";2012;175;11;83;94;6,3;47,4;53,7
53;"Piraí";2012;409;69;129;198;16,9;31,5;48,4
54;"Porciúncula";2012;369;92;92;184;24,9;24,9;49,9
55;"Porto Real-Quatis";2012;415;27;129;156;6,5;31,1;37,6
56;"Queimados";2012;538;6;87;93;1,1;16,2;17,3
57;"Resende";2012;1358;148;379;527;10,9;27,9;38,8
58;"Rio Bonito";2012;669;105;181;286;15,7;27,1;42,8
59;"Rio Claro";2012;376;43;166;209;11,4;44,1;55,6
60;"Rio Das Flores";2012;106;21;46;67;19,8;43,4;63,2
61;"Rio Das Ostras";2012;1465;262;724;986;17,9;49,4;67,3
62;"Santa Maria Madalena";2012;215;25;71;96;11,6;33;44,7
63;"Santo Antônio de Pádua";2012;796;101;246;347;12,7;30,9;43,6
64;"São Fidélis";2012;351;91;135;226;25,9;38,5;64,4
65;"São Francisco do Itabapoana";2012;1099;90;526;616;8,2;47,9;56,1
66;"São Gonçalo";2012;6772;758;3729;4487;11,2;55,1;66,3
67;"São João da Barra";2012;1081;172;302;474;15,9;27,9;43,8
68;"São João de Meriti";2012;1704;2;93;95;0,1;5,5;5,6
69;"São José do Vale do Rio Preto";2012;155;24;41;65;15,5;26,5;41,9
70;"São Pedro da Aldeia";2012;1194;135;313;448;11,3;26,2;37,5
71;"São Sebastião do Alto";2012;109;9;21;30;8,3;19,3;27,5
72;"Sapucaia";2012;249;45;57;102;18,1;22,9;41
73;"Saquarema";2012;902;77;277;354;8,5;30,7;39,2
74;"Seropédica";2012;833;82;285;367;9,8;34,2;44,1
75;"Silva Jardim";2012;357;40;87;127;11,2;24,4;35,6
76;"Sumidouro";2012;102;32;27;59;31,4;26,5;57,8
78;"Teresópolis";2012;2530;542;894;1436;21,4;35,3;56,8
79;"Trajano de Moraes";2012;147;12;81;93;8,2;55,1;63,3
80;"Três Rios";2012;1562;394;455;849;25,2;29,1;54,4
81;"Valença";2012;645;166;254;420;25,7;39,4;65,1
82;"Vassouras";2012;789;120;404;524;15,2;51,2;66,4
83;"Volta Redonda";2012;2207;680;780;1460;30,8;35,3;66,2
1;"Angra dos Reis";2011;2662;135;1593;1728;5,1;59,8;64,9
2;"Araruama";2011;2386;103;1277;1380;4,3;53,5;57,8
3;"Armação dos Búzios";2011;667;48;308;356;7,2;46,2;53,4
4;"Arraial do Cabo";2011;762;26;340;366;3,4;44,6;48
5;"Barra do Piraí";2011;1080;89;388;477;8,2;35,9;44,2
6;"Barra Mansa";2011;1608;401;520;921;24,9;32,3;57,3
7;"Belford Roxo";2011;422;3;26;29;0,7;6,2;6,9
8;"Bom Jardim";2011;415;40;223;263;9,6;53,7;63,4
9;"Bom Jesus do Itabapoana";2011;475;50;101;151;10,5;21,3;31,8
10;"Cabo Frio";2011;3839;316;1810;2126;8,2;47,1;55,4
11;"Cachoeiras de Macacu";2011;974;120;292;412;12,3;30;42,3
12;"Cambuci";2011;277;33;73;106;11,9;26,4;38,3
13;"Campos dos Goytacazes";2011;5866;702;1442;2144;12;24,6;36,5
14;"Cantagalo";2011;253;57;47;104;22,5;18,6;41,1
15;"Rio de Janeiro";2011;86113;13061;41952;55013;15,2;48,7;63,9
16;"Carapebus/Quissamã";2011;795;60;352;412;7,5;44,3;51,8
17;"Carmo";2011;264;59;65;124;22,3;24,6;47
18;"Casimiro de Abreu";2011;1016;92;336;428;9,1;33,1;42,1
19;"Conceição de Macabu";2011;808;56;341;397;6,9;42,2;49,1
20;"Cordeiro";2011;495;55;111;166;11,1;22,4;33,5
21;"Duas Barras";2011;196;10;62;72;5,1;31,6;36,7
22;"Duque de Caxias";2011;16957;2085;11928;14013;12,3;70,3;82,6
23;"Engenheiro Paulo de Frontin";2011;177;16;79;95;9;44,6;53,7
24;"Guapimirim";2011;285;30;75;105;10,5;26,3;36,8
25;"Iguaba Grande";2011;222;37;49;86;16,7;22,1;38,7
26;"Itaboraí";2011;5640;284;3969;4253;5;70,4;75,4
27;"Itaguaí";2011;1420;246;750;996;17,3;52,8;70,1
28;"Italva(Cardoso Moreira)";2011;439;66;141;207;15;32,1;47,2
29;"Itaocara";2011;256;30;91;121;11,7;35,5;47,3
30;"Itaperuna";2011;893;71;288;359;8;32,3;40,2
31;"Itatiaia";2011;307;68;99;167;22,1;32,2;54,4
32;"Japeri";2011;1024;42;274;316;4,1;26,8;30,9
33;"Laje do Muriaé";2011;71;14;21;35;19,7;29,6;49,3
34;"Macaé";2011;5596;284;2634;2918;5,1;47,1;52,1
35;"Magé";2011;2909;125;526;651;4,3;18,1;22,4
36;"Mangaratiba";2011;1168;80;718;798;6,8;61,5;68,3
37;"Maricá";2011;1458;195;504;699;13,4;34,6;47,9
38;"Mendes";2011;46;2;18;20;4,3;39,1;43,5
40;"Miguel Pereira";2011;314;73;138;211;23,2;43,9;67,2
41;"Miracema";2011;711;102;221;323;14,3;31,1;45,4
42;"Natividade";2011;269;84;84;168;31,2;31,2;62,5
43;"Nilópolis";2011;198;1;42;43;0,5;21,2;21,7
44;"Niterói";2011;6069;1233;2888;4121;20,3;47,6;67,9
45;"Nova Friburgo";2011;4014;257;1700;1957;6,4;42,4;48,8
46;"Nova Iguaçu";2011;16640;1661;10828;12489;10;65,1;75,1
47;"Paracambi";2011;865;82;265;347;9,5;30,6;40,1
48;"Paraíba do Sul";2011;553;108;95;203;19,5;17,2;36,7
49;"Paraty";2011;439;138;95;233;31,4;21,6;53,1
50;"Paty do Alferes";2011;57;17;19;36;29,8;33,3;63,2
51;"Petrópolis";2011;2329;989;627;1616;42,5;26,9;69,4
52;"Pinheiral";2011;301;29;171;200;9,6;56,8;66,4
53;"Piraí";2011;428;41;146;187;9,6;34,1;43,7
54;"Porciúncula";2011;581;72;157;229;12,4;27;39,4
55;"Porto Real-Quatis";2011;425;54;98;152;12,7;23,1;35,8
56;"Queimados";2011;715;18;148;166;2,5;20,7;23,2
57;"Resende";2011;3851;178;900;1078;4,6;23,4;28
58;"Rio Bonito";2011;512;47;124;171;9,2;24,2;33,4
59;"Rio Claro";2011;299;26;109;135;8,7;36,5;45,2
60;"Rio Das Flores";2011;91;11;6;17;12,1;6,6;18,7
61;"Rio Das Ostras";2011;1446;162;736;898;11,2;50,9;62,1
62;"Santa Maria Madalena";2011;124;16;55;71;12,9;44,4;57,3
63;"Santo Antônio de Pádua";2011;809;92;391;483;11,4;48,3;59,7
64;"São Fidélis";2011;391;106;139;245;27,1;35,5;62,7
65;"São Francisco do Itabapoana";2011;563;45;151;196;8;26,8;34,8
66;"São Gonçalo";2011;8593;651;4843;5494;7,6;56,4;63,9
67;"São João da Barra";2011;995;88;320;408;8,8;32,2;41
68;"São João de Meriti";2011;1986;5;136;141;0,3;6,8;7,1
69;"São José do Vale do Rio Preto";2011;187;14;79;93;7,5;42,2;49,7
70;"São Pedro da Aldeia";2011;1126;184;262;446;16,3;23,3;39,6
71;"São Sebastião do Alto";2011;144;10;25;35;6,9;17,4;24,3
72;"Sapucaia";2011;902;57;195;252;6,3;21,6;27,9
73;"Saquarema";2011;1765;121;686;807;6,9;38,9;45,7
74;"Seropédica";2011;991;48;413;461;4,8;41,7;46,5
75;"Silva Jardim";2011;412;23;87;110;5,6;21,1;26,7
76;"Sumidouro";2011;150;40;44;84;26,7;29,3;56
78;"Teresópolis";2011;2941;372;889;1261;12,6;30,2;42,9
79;"Trajano de Moraes";2011;123;20;67;87;16,3;54,5;70,7
80;"Três Rios";2011;2073;425;987;1412;20,5;47,6;68,1
81;"Valença";2011;1040;210;281;491;20,2;27;47,2
82;"Vassouras";2011;342;45;209;254;13,2;61,1;74,3
83;"Volta Redonda";2011;2409;630;924;1554;26,2;38,4;64,5
1;"Angra dos Reis";2010;5843;229;4967;5196;3,9;85;88,9
2;"Araruama";2010;1251;63;765;828;5;61,2;66,2
3;"Armação dos Búzios";2010;700;87;362;449;12,4;51,7;64,1
4;"Arraial do Cabo";2010;184;5;77;82;2,7;41,8;44,6
5;"Barra do Piraí";2010;1747;187;1087;1274;10,7;62,2;72,9
6;"Barra Mansa";2010;4502;600;2859;3459;13,3;63,5;76,8
7;"Belford Roxo";2010;40;0;3;3;0;7,5;7,5
8;"Bom Jardim";2010;245;25;116;141;10,2;47,3;57,6
9;"Bom Jesus do Itabapoana";2010;301;17;46;63;5,6;15,3;20,9
10;"Cabo Frio";2010;2523;146;1506;1652;5,8;59,7;65,5
11;"Cachoeiras de Macacu";2010;1427;112;437;549;7,8;30,6;38,5
12;"Cambuci";2010;301;36;162;198;12;53,8;65,8
13;"Campos dos Goytacazes";2010;13682;1369;7080;8449;10;51,7;61,8
14;"Cantagalo";2010;304;67;158;225;22;52;74
15;"Rio de Janeiro";2010;52427;10230;30041;40271;19,5;57,3;76,8
16;"Carapebus/Quissamã";2010;932;69;529;598;7,4;56,8;64,2
17;"Carmo";2010;223;55;51;106;24,7;22,9;47,5
18;"Casimiro de Abreu";2010;1374;97;411;508;7,1;29,9;37
19;"Conceição de Macabu";2010;197;16;142;158;8,1;72,1;80,2
20;"Cordeiro";2010;536;53;153;206;9,9;28,5;38,4
21;"Duas Barras";2010;131;20;48;68;15,3;36,6;51,9
22;"Duque de Caxias";2010;13251;2589;9146;11735;19,5;69;88,6
23;"Engenheiro Paulo de Frontin";2010;198;27;106;133;13,6;53,5;67,2
24;"Guapimirim";2010;52;4;14;18;7,7;26,9;34,6
25;"Iguaba Grande";2010;262;66;91;157;25,2;34,7;59,9
26;"Itaboraí";2010;2959;190;1973;2163;6,4;66,7;73,1
27;"Itaguaí";2010;2953;213;1885;2098;7,2;63,8;71
28;"Italva(Cardoso Moreira)";2010;227;32;86;118;14,1;37,9;52
29;"Itaocara";2010;289;26;86;112;9;29,8;38,8
30;"Itaperuna";2010;623;41;178;219;6,6;28,6;35,2
31;"Itatiaia";2010;363;102;170;272;28,1;46,8;74,9
32;"Japeri";2010;895;25;260;285;2,8;29,1;31,8
33;"Laje do Muriaé";2010;37;5;4;9;13,5;10,8;24,3
34;"Macaé";2010;4923;151;1691;1842;3,1;34,3;37,4
35;"Magé";2010;4410;169;1626;1795;3,8;36,9;40,7
36;"Mangaratiba";2010;457;29;274;303;6,3;60;66,3
37;"Maricá";2010;3822;351;2439;2790;9,2;63,8;73
38;"Mendes";2010;138;3;45;48;2,2;32,6;34,8
40;"Miguel Pereira";2010;297;81;152;233;27,3;51,2;78,5
41;"Miracema";2010;620;81;318;399;13,1;51,3;64,4
42;"Natividade";2010;173;85;58;143;49,1;33,5;82,7
43;"Nilópolis";2010;118;0;34;34;0;28,8;28,8
44;"Niterói";2010;5632;1028;3946;4974;18,3;70,1;88,3
45;"Nova Friburgo";2010;1160;153;486;639;13,2;41,9;55,1
46;"Nova Iguaçu";2010;10571;1487;7864;9351;14,1;74,4;88,5
47;"Paracambi";2010;768;61;368;429;7,9;47,9;55,9
48;"Paraíba do Sul";2010;929;150;391;541;16,1;42,1;58,2
49;"Paraty";2010;1231;158;679;837;12,8;55,2;68
50;"Paty do Alferes";2010;12;1;6;7;8,3;50;58,3
51;"Petrópolis";2010;3021;1014;1186;2200;33,6;39,3;72,8
52;"Pinheiral";2010;26;4;16;20;15,4;61,5;76,9
53;"Piraí";2010;353;35;145;180;9,9;41,1;51
54;"Porciúncula";2010;373;75;144;219;20,1;38,6;58,7
55;"Porto Real-Quatis";2010;554;78;193;271;14,1;34,8;48,9
56;"Queimados";2010;20;1;8;9;5;40;45
57;"Resende";2010;2619;152;996;1148;5,8;38;43,8
58;"Rio Bonito";2010;1249;84;744;828;6,7;59,6;66,3
59;"Rio Claro";2010;307;26;151;177;8,5;49,2;57,7
60;"Rio Das Flores";2010;77;0;4;4;0;5,2;5,2
61;"Rio Das Ostras";2010;723;98;359;457;13,6;49,7;63,2
62;"Santa Maria Madalena";2010;233;22;88;110;9,4;37,8;47,2
63;"Santo Antônio de Pádua";2010;1762;117;769;886;6,6;43,6;50,3
64;"São Fidélis";2010;523;109;241;350;20,8;46,1;66,9
65;"São Francisco do Itabapoana";2010;1251;56;398;454;4,5;31,8;36,3
66;"São Gonçalo";2010;6195;543;4321;4864;8,8;69,7;78,5
67;"São João da Barra";2010;798;59;233;292;7,4;29,2;36,6
68;"São João de Meriti";2010;148;1;64;65;0,7;43,2;43,9
69;"São José do Vale do Rio Preto";2010;227;19;137;156;8,4;60,4;68,7
70;"São Pedro da Aldeia";2010;1671;212;1011;1223;12,7;60,5;73,2
71;"São Sebastião do Alto";2010;109;16;19;35;14,7;17,4;32,1
72;"Sapucaia";2010;327;21;13;34;6,4;4;10,4
73;"Saquarema";2010;341;35;163;198;10,3;47,8;58,1
74;"Seropédica";2010;2072;89;1356;1445;4,3;65,4;69,7
75;"Silva Jardim";2010;190;8;16;24;4,2;8,4;12,6
76;"Sumidouro";2010;91;46;22;68;50,5;24,2;74,7
78;"Teresópolis";2010;4694;525;3145;3670;11,2;67;78,2
79;"Trajano de Moraes";2010;107;28;65;93;26,2;60,7;86,9
80;"Três Rios";2010;588;148;340;488;25,2;57,8;83
81;"Valença";2010;1418;164;873;1037;11,6;61,6;73,1
82;"Vassouras";2010;959;47;813;860;4,9;84,8;89,7
83;"Volta Redonda";2010;2752;651;1140;1791;23,7;41,4;65,1
